1_ortho	4_cgram	5_genre
sommes	VER	na
étant	VER	na
étaient	VER	na
étais	VER	na
êtes	VER	na
être	VER	na
était	VER	na
soit	VER	na
fus	VER	na
suis	VER	na
fusse	VER	na
étiez	VER	na
fussent	VER	na
fusses	VER	na
étions	VER	na
fussions	VER	na
furent	VER	na
sont	VER	na
es	VER	na
seront	VER	na
serons	VER	na
été	VER	m
serions	VER	na
sera	VER	na
seriez	VER	na
serez	VER	na
soyez	VER	na
soyons	VER	na
seras	VER	na
serait	VER	na
serais	VER	na
serai	VER	na
seraient	VER	na
fut	VER	na
fussiez	VER	na
fût	VER	na
est	VER	na
fûtes	VER	na
sois	VER	na
soient	VER	na
fûmes	VER	na
je	PRO:per	na
de	PRE	na
n'	ADV	na
n	ADV	na
ne	ADV	na
ont	AUX	na
as	AUX	na
ayant	AUX	na
aurions	AUX	na
aurons	AUX	na
ai	AUX	na
auront	AUX	na
ayez	AUX	na
eût	AUX	na
auriez	AUX	na
aura	AUX	na
eûmes	AUX	na
avons	AUX	na
aie	AUX	na
aient	AUX	na
aies	AUX	na
aurai	AUX	na
eut	AUX	na
s	AUX	na
eussé	AUX	na
eussions	AUX	na
eussiez	AUX	na
eusses	AUX	na
eussent	AUX	na
eusse	AUX	na
eus	AUX	m
eurent	AUX	na
eues	AUX	f
a	AUX	na
eue	AUX	f
aurais	AUX	na
avaient	AUX	na
aviez	AUX	na
aurait	AUX	na
avions	AUX	na
avait	AUX	na
ait	AUX	na
auras	AUX	na
avais	AUX	na
aurez	AUX	na
avoir	AUX	na
avez	AUX	na
ayons	AUX	na
n'	AUX	na
eu	AUX	m
auraient	AUX	na
pas	ADV	na
la	ART:def	f
tu	PRO:per	na
le	ART:def	m
vous	PRO:per	na
eut	VER	na
eussions	VER	na
aviez	VER	na
eussé	VER	na
avions	VER	na
a	VER	na
aurait	VER	na
avoir	VER	na
eussiez	VER	na
ayez	VER	na
eurent	VER	na
eusses	VER	na
eussent	VER	na
ayons	VER	na
auras	VER	na
avez	VER	na
eusse	VER	na
eues	VER	f
aurez	VER	na
eus	VER	m
aurai	VER	na
ai	VER	na
eûtes	VER	na
ayant	VER	na
avais	VER	na
eu	VER	m
avaient	VER	na
auront	VER	na
ont	VER	na
aurions	VER	na
avons	VER	na
auriez	VER	na
eût	VER	na
avait	VER	na
auraient	VER	na
as	VER	na
eûmes	VER	na
ait	VER	na
aurais	VER	na
aie	VER	na
aient	VER	na
eue	VER	f
aies	VER	na
aura	VER	na
aurons	VER	na
il	PRO:per	m
et	CON	na
à	PRE	na
un	ART:ind	m
ailles	VER	na
allons	VER	na
va	VER	na
allées	VER	f
allée	VER	f
allez	VER	na
allier	VER	na
alliez	VER	na
aille	VER	na
vont	VER	na
allâmes	VER	na
allât	VER	na
aillent	VER	na
allions	VER	na
allé	VER	m
allèrent	VER	na
allaient	VER	na
vais	VER	na
allait	VER	na
iront	VER	na
irons	VER	na
irions	VER	na
iriez	VER	na
irez	VER	na
iras	VER	na
irait	VER	na
irais	VER	na
iraient	VER	na
ira	VER	na
alla	VER	na
allai	VER	na
allais	VER	na
irai	VER	na
allas	VER	na
allant	VER	na
vas	VER	na
allés	VER	m
allassent	VER	na
aller	VER	na
ça	PRO:dem	na
fassiez	VER	na
fis	VER	na
fisse	VER	na
fassions	VER	na
fissent	VER	na
feront	VER	na
ferez	VER	na
fasses	VER	na
fissiez	VER	na
fissions	VER	na
firent	VER	na
fera	VER	na
ferait	VER	na
feriez	VER	na
font	VER	na
ferai	VER	na
ferions	VER	na
ferais	VER	na
feras	VER	na
feraient	VER	na
fasse	VER	na
ferons	VER	na
fassent	VER	na
fit	VER	na
faits	VER	m
faisait	VER	na
faites	VER	f
fîmes	VER	na
fît	VER	na
faire	VER	na
fais	VER	na
faisaient	VER	na
faisais	VER	na
fîtes	VER	na
faisant	VER	na
fait	VER	m
faisiez	VER	na
faisions	VER	na
faite	VER	f
faisons	VER	na
les	ART:def	na
on	PRO:per	na
l'	ART:def	m
soient	AUX	na
sois	AUX	na
étions	AUX	na
sommes	AUX	na
étiez	AUX	na
étant	AUX	na
était	AUX	na
étais	AUX	na
étaient	AUX	na
seras	AUX	na
sont	AUX	na
été	AUX	m
seront	AUX	na
serons	AUX	na
serions	AUX	na
serez	AUX	na
serait	AUX	na
serais	AUX	na
seraient	AUX	na
serai	AUX	na
sera	AUX	na
suis	AUX	na
est	AUX	na
seriez	AUX	na
soit	AUX	na
être	AUX	na
es	AUX	na
fussent	AUX	na
fusses	AUX	na
fussiez	AUX	na
fussions	AUX	na
fut	AUX	na
soyez	AUX	na
soyons	AUX	na
furent	AUX	na
fus	AUX	na
êtes	AUX	na
fûtes	AUX	na
fût	AUX	na
fûmes	AUX	na
fusse	AUX	na
une	ART:ind	f
d'	PRE	na
pour	PRE	na
des	ART:ind	na
dite	VER	f
dire	VER	na
disent	VER	na
dirais	VER	na
dites	VER	f
dit	VER	m
dirait	VER	na
dirai	VER	na
dirent	VER	na
dira	VER	na
disons	VER	na
dîmes	VER	na
dît	VER	na
dîtes	VER	na
dise	VER	na
disions	VER	na
disiez	VER	na
diraient	VER	na
diras	VER	na
dirons	VER	na
dissent	VER	na
diriez	VER	na
dirions	VER	na
dises	VER	na
disant	VER	na
disait	VER	na
dits	VER	m
diront	VER	na
direz	VER	na
disaient	VER	na
disais	VER	na
dis	VER	na
en	PRE	na
puis	VER	na
puisse	VER	na
pûtes	VER	na
peut	VER	na
pourront	VER	na
pouvaient	VER	na
peuvent	VER	na
pourriez	VER	na
pourrons	VER	na
pourrions	VER	na
pouvait	VER	na
pourrez	VER	na
pourras	VER	na
pourrait	VER	na
pourrais	VER	na
pourraient	VER	na
pourrai	VER	na
pourra	VER	na
pouvais	VER	na
puissiez	VER	na
peux	VER	na
pouvons	VER	na
pus	VER	na
pût	VER	na
pusses	VER	na
pussiez	VER	na
put	VER	na
purent	VER	na
puissent	VER	na
pincer	VER	na
pouvoir	VER	na
pusse	VER	na
pûmes	VER	na
pouvions	VER	na
pouviez	VER	na
pouvez	VER	na
pu	VER	m
pouvant	VER	na
puissions	VER	na
puisses	VER	na
pussent	VER	na
qui	PRO:rel	na
qui	PRO:int	na
voulions	VER	na
voulons	VER	na
voulu	VER	m
voudriez	VER	na
vouloir	VER	na
vouliez	VER	na
voulez	VER	na
voulant	VER	na
voudrions	VER	na
voudrons	VER	na
voudras	VER	na
voulait	VER	na
voulais	VER	na
voudrez	VER	na
voulût	VER	na
voudrait	VER	na
voulusse	VER	na
veuille	VER	na
veuillent	VER	na
veuilles	VER	na
veuillez	VER	na
veulent	VER	na
veut	VER	na
veux	VER	na
voudrais	VER	na
voudront	VER	na
voulûmes	VER	na
voulut	VER	na
voulussent	VER	na
voulaient	VER	na
voulus	VER	m
voulurent	VER	na
voulues	VER	f
voudraient	VER	na
voulue	VER	f
voudrai	VER	na
voudra	VER	na
ce	PRO:dem	m
mais	CON	na
me	PRO:per	na
nous	PRO:per	na
dans	PRE	na
elle	PRO:per	f
sachons	VER	na
su	VER	m
sus	VER	m
sachez	VER	na
sue	VER	f
sachiez	VER	na
sues	VER	f
susse	VER	na
sussent	VER	na
sut	VER	na
sachant	VER	na
sache	VER	na
saches	VER	na
sachions	VER	na
sachent	VER	na
saurons	VER	na
saurais	VER	na
saura	VER	na
savions	VER	na
sût	VER	na
savoir	VER	na
sûmes	VER	na
savons	VER	na
surent	VER	na
saurai	VER	na
savez	VER	na
sauraient	VER	na
saurait	VER	na
sauront	VER	na
sauras	VER	na
saurez	VER	na
saurions	VER	na
saviez	VER	na
sauriez	VER	na
savais	VER	na
sait	VER	na
savaient	VER	na
sais	VER	na
savait	VER	na
savent	VER	na
du	ART:def	m
y	PRO:per	na
t'	PRO:per	na
bien	ADV	na
voyant	VER	na
voyiez	VER	na
verrez	VER	na
voyez	VER	na
verront	VER	na
vîmes	VER	na
verrons	VER	na
verrions	VER	na
voyais	VER	na
vis	VER	na
voyait	VER	na
vit	VER	na
vois	VER	na
vus	VER	m
verriez	VER	na
voyaient	VER	na
vît	VER	na
vues	VER	f
voie	VER	na
vue	VER	f
vissent	VER	na
voit	VER	na
vu	VER	m
verra	VER	na
verrai	VER	na
voies	VER	na
verraient	VER	na
verrais	VER	na
verrait	VER	na
verras	VER	na
voyons	VER	na
voir	VER	na
voyions	VER	na
voient	VER	na
que	PRO:int	na
que	PRO:rel	na
plus	ADV	na
non	ADV	na
te	PRO:per	na
mon	ADJ:pos	na
au	ART:def	m
avec	PRE	na
moi	PRO:per	na
en	PRO:per	na
le	PRO:per	m
l'	PRO:per	na
dues	VER	f
devras	VER	na
durent	VER	na
dus	VER	m
devrai	VER	na
devra	VER	na
doit	VER	na
devrait	VER	na
doive	VER	na
doivent	VER	na
doives	VER	na
devrez	VER	na
due	VER	f
dois	VER	na
devrions	VER	na
dusse	VER	na
dû	VER	m
devront	VER	na
devez	VER	na
devant	VER	na
devrons	VER	na
devait	VER	na
devais	VER	na
devaient	VER	na
dussent	VER	na
devriez	VER	na
dût	VER	na
dûmes	VER	na
deviez	VER	na
devraient	VER	na
devions	VER	na
dussions	VER	na
dussiez	VER	na
dusses	VER	na
dut	VER	na
devons	VER	na
devoir	VER	na
devrais	VER	na
oui	ADV	na
ils	PRO:per	m
tous	ADJ	m
tout	ADJ	m
toute	ADJ	f
tout	ADJ:ind	m
toutes	ADJ	f
se	PRO:per	na
venir	VER	na
veniez	VER	na
venez	VER	na
venions	VER	na
venais	VER	na
venons	VER	na
venu	VER	m
venue	VER	f
venues	VER	f
venaient	VER	na
vînt	VER	na
venant	VER	na
venait	VER	na
venus	VER	m
vins	VER	na
viendrait	VER	na
viens	VER	na
viennent	VER	na
vient	VER	na
vienne	VER	na
viendront	VER	na
viendrons	VER	na
viendrions	VER	na
viendriez	VER	na
viendrez	VER	na
viendras	VER	na
viennes	VER	na
viendrais	VER	na
viendraient	VER	na
viendrai	VER	na
viendra	VER	na
vinrent	VER	na
vint	VER	na
vinssent	VER	na
vinsse	VER	na
ce	ADJ:dem	m
sur	PRE	na
toi	PRO:per	na
s'	PRO:per	na
ici	ADV	na
rien	PRO:ind	na
ma	ADJ:pos	na
comme	CON	na
lui	PRO:per	na
où	PRO:int	na
où	PRO:rel	na
si	ADV	na
là	ADV	na
suivait	VER	na
suivez	VER	na
suives	VER	na
suivent	VER	na
suive	VER	na
suivant	VER	na
suivrions	VER	na
suivîmes	VER	na
suivais	VER	na
suivaient	VER	na
suivi	VER	m
suis	VER	na
suivît	VER	na
suit	VER	na
suivie	VER	f
suivriez	VER	na
suivies	VER	f
suivrez	VER	na
suivre	VER	na
suivras	VER	na
suivrait	VER	na
suivrai	VER	na
suivra	VER	na
suivrons	VER	na
suivons	VER	na
suivit	VER	na
suivissent	VER	na
suivis	VER	m
suivirent	VER	na
suivions	VER	na
suivront	VER	na
suiviez	VER	na
suivrais	VER	na
suivraient	VER	na
parlés	VER	m
parleriez	VER	na
parleront	VER	na
parlerons	VER	na
parla	VER	na
parlai	VER	na
parlaient	VER	na
parlais	VER	na
parlait	VER	na
parlant	VER	na
parlerions	VER	na
parlas	VER	na
parlerez	VER	na
parlez	VER	na
parleras	VER	na
parlerait	VER	na
parlerais	VER	na
parlerai	VER	na
parlera	VER	na
parlassent	VER	na
parler	VER	na
parlent	VER	na
parle	VER	na
parlasses	VER	na
parles	VER	na
parleraient	VER	na
parliez	VER	na
parlâmes	VER	na
parlées	VER	f
parlée	VER	f
parlé	VER	m
parlèrent	VER	na
parlât	VER	na
parlions	VER	na
parlons	VER	na
prendra	VER	na
prendrons	VER	na
prennes	VER	na
prennent	VER	na
prenne	VER	na
prenions	VER	na
preniez	VER	na
prenez	VER	na
prenait	VER	na
prends	VER	na
prendront	VER	na
prendrions	VER	na
prendrai	VER	na
prendriez	VER	na
prendrez	VER	na
prendre	VER	na
prenons	VER	na
prendrait	VER	na
prenant	VER	na
prendrais	VER	na
prendraient	VER	na
prend	VER	na
prendras	VER	na
prirent	VER	na
prenais	VER	na
prenaient	VER	na
prîmes	VER	na
passer	VER	na
pris	VER	m
prise	VER	f
prises	VER	f
prisse	VER	na
prissent	VER	na
prissions	VER	na
prît	VER	na
prit	VER	na
cette	ADJ:dem	f
votre	ADJ:pos	na
quand	CON	na
alors	ADV	na
chose	NOM	f
choses	NOM	f
par	PRE	na
son	ADJ:pos	na
ton	ADJ:pos	na
croies	VER	na
cru	VER	m
crûmes	VER	na
croyez	VER	na
croyiez	VER	na
croient	VER	na
croyons	VER	na
croie	VER	na
croyions	VER	na
crût	VER	na
croiras	VER	na
croit	VER	na
croiront	VER	na
croirons	VER	na
croirions	VER	na
croiriez	VER	na
croirez	VER	na
croire	VER	na
croirait	VER	na
croirais	VER	na
croiraient	VER	na
croirai	VER	na
croira	VER	na
crue	VER	f
crues	VER	f
crurent	VER	na
crus	VER	m
crusse	VER	na
crussent	VER	na
crusses	VER	na
crut	VER	na
crois	VER	na
croyant	VER	na
croyait	VER	na
croyaient	VER	na
croyais	VER	na
aimeras	VER	na
aimiez	VER	na
aimez	VER	na
aimait	VER	na
aimais	VER	na
aimerez	VER	na
aimai	VER	na
aima	VER	na
aimions	VER	na
aimasse	VER	na
aimons	VER	na
aimâmes	VER	na
aimés	VER	m
aimées	VER	f
aimée	VER	f
aimé	VER	m
aimèrent	VER	na
aimant	VER	na
aimaient	VER	na
aimassent	VER	na
aimer	VER	na
aimeriez	VER	na
aimerions	VER	na
aimerons	VER	na
aimerait	VER	na
aimerais	VER	na
aimeraient	VER	na
aimerai	VER	na
aimera	VER	na
aimât	VER	na
aimâtes	VER	na
aimes	VER	na
aimeront	VER	na
aime	VER	na
aiment	VER	na
aimassions	VER	na
fallait	VER	na
falloir	VER	na
faudra	VER	na
fallut	VER	na
fallût	VER	na
faudrait	VER	na
faut	VER	na
fallu	VER	m
très	ADV	na
ou	CON	na
quoi	ADJ	m
bon	ADJ	m
bons	ADJ	m
bonne	ADJ	f
bonnes	ADJ	f
passa	VER	na
passèrent	VER	na
passai	VER	na
passerions	VER	na
passas	VER	na
passe	VER	na
passent	VER	na
passer	VER	na
passera	VER	na
passerai	VER	na
passeraient	VER	na
passerais	VER	na
passerait	VER	na
passeras	VER	na
passerez	VER	na
passeriez	VER	na
passerons	VER	na
passait	VER	na
passeront	VER	na
passes	VER	na
passez	VER	na
passiez	VER	na
passions	VER	na
passons	VER	na
passâmes	VER	na
passâtes	VER	na
passé	VER	m
passée	VER	f
passées	VER	f
passés	VER	m
passant	VER	na
passât	VER	na
passais	VER	na
passaient	VER	na
penser	VER	na
pense	VER	na
penserait	VER	na
penserais	VER	na
penseraient	VER	na
penserai	VER	na
pensera	VER	na
pensent	VER	na
penseriez	VER	na
pensa	VER	na
pensai	VER	na
pensaient	VER	na
pensais	VER	na
pensait	VER	na
pensant	VER	na
penserez	VER	na
penseras	VER	na
penserions	VER	na
pensée	VER	f
penseront	VER	na
penses	VER	na
pensez	VER	na
pensiez	VER	na
pensions	VER	na
pensons	VER	na
pensâmes	VER	na
pensât	VER	na
pensés	VER	m
penserons	VER	na
pensées	VER	f
pensèrent	VER	na
pensé	VER	m
aussi	ADV	na
si	CON	na
tout	PRO:ind	m
jamais	ADV	na
attendus	VER	m
attendît	VER	na
attendîmes	VER	na
attendues	VER	f
attendrons	VER	na
attendue	VER	f
attendis	VER	na
attendrions	VER	na
attendriez	VER	na
attendrez	VER	na
attendre	VER	na
attendras	VER	na
attendrait	VER	na
attendrais	VER	na
attendraient	VER	na
attendrai	VER	na
attendra	VER	na
attendons	VER	na
attendit	VER	na
attendissent	VER	na
attendisse	VER	na
attendirent	VER	na
attendu	VER	m
attendions	VER	na
attendiez	VER	na
attendez	VER	na
attendes	VER	na
attendent	VER	na
attend	VER	na
attende	VER	na
attendant	VER	na
attendait	VER	na
attendais	VER	na
attendaient	VER	na
attendront	VER	na
attends	VER	na
pourquoi	ADV	na
trouvent	VER	na
trouver	VER	na
trouvâmes	VER	na
trouves	VER	na
trouvas	VER	na
trouvasse	VER	na
trouvées	VER	f
trouvera	VER	na
trouvassent	VER	na
trouvions	VER	na
trouvés	VER	m
trouviez	VER	na
trouvez	VER	na
trouveront	VER	na
trouvant	VER	na
trouvons	VER	na
trouverons	VER	na
trouverions	VER	na
trouveriez	VER	na
trouverez	VER	na
trouveras	VER	na
trouverait	VER	na
trouverais	VER	na
trouveraient	VER	na
trouvée	VER	f
trouverai	VER	na
trouvait	VER	na
trouvaient	VER	na
trouva	VER	na
trouvé	VER	m
trouvai	VER	na
trouve	VER	na
trouvais	VER	na
trouvèrent	VER	na
trouvât	VER	na
laissa	VER	na
laissai	VER	na
laissant	VER	na
laissaient	VER	na
laissés	VER	m
laissées	VER	f
laissais	VER	na
laissé	VER	m
laissèrent	VER	na
laissât	VER	na
laissâmes	VER	na
laissons	VER	na
laissait	VER	na
laisse	VER	na
laissassent	VER	na
laisserais	VER	na
laisserait	VER	na
laisseras	VER	na
laisseraient	VER	na
laisserai	VER	na
laisseriez	VER	na
laissera	VER	na
laisserions	VER	na
laisserons	VER	na
laisseront	VER	na
laisses	VER	na
laisser	VER	na
laissez	VER	na
laissent	VER	na
laissiez	VER	na
laissions	VER	na
laisserez	VER	na
laissée	VER	f
sa	ADJ:pos	na
ta	ADJ:pos	na
arrives	VER	na
arrivent	VER	na
arrivassent	VER	na
arrivai	VER	na
arrivas	VER	na
arrivez	VER	na
arrivés	VER	m
arriveront	VER	na
arriverez	VER	na
arriviez	VER	na
arriveriez	VER	na
arriverions	VER	na
arriver	VER	na
arriverai	VER	na
arriverais	VER	na
arriverons	VER	na
arrivâmes	VER	na
arrivera	VER	na
arriveras	VER	na
arriverait	VER	na
arrivions	VER	na
arrivaient	VER	na
arrivais	VER	na
arrivait	VER	na
arrivant	VER	na
arrivâtes	VER	na
arrivât	VER	na
arrivèrent	VER	na
arrivé	VER	m
arrive	VER	na
arriveraient	VER	na
arriva	VER	na
arrivée	VER	f
arrivées	VER	f
arrivons	VER	na
les	PRO:per	na
ces	ADJ:dem	na
donnait	VER	na
donnerais	VER	na
donniez	VER	na
donnais	VER	na
donnaient	VER	na
donnant	VER	na
donna	VER	na
donnai	VER	na
donnions	VER	na
donnons	VER	na
donnâmes	VER	na
donnât	VER	na
donnèrent	VER	na
donné	VER	m
donnée	VER	f
donnez	VER	na
donnerions	VER	na
donnes	VER	na
donnerez	VER	na
donneraient	VER	na
donnerai	VER	na
donnera	VER	na
donner	VER	na
donneront	VER	na
donnerait	VER	na
donneras	VER	na
données	VER	f
donnent	VER	na
donneriez	VER	na
donnas	VER	na
donnassent	VER	na
donne	VER	na
donnés	VER	m
donnerons	VER	na
regarderai	VER	na
regarder	VER	na
regardent	VER	na
regardés	VER	m
regardées	VER	f
regardiez	VER	na
regardé	VER	m
regardèrent	VER	na
regardât	VER	na
regardâmes	VER	na
regardons	VER	na
regardions	VER	na
regardée	VER	f
regarde	VER	na
regarderas	VER	na
regardais	VER	na
regardaient	VER	na
regarderez	VER	na
regardai	VER	na
regarderais	VER	na
regarda	VER	na
regarderiez	VER	na
regarderions	VER	na
regardez	VER	na
regarderait	VER	na
regarderons	VER	na
regarderont	VER	na
regardait	VER	na
regarderaient	VER	na
regardes	VER	na
regardant	VER	na
regardera	VER	na
encore	ADV	na
appellerons	VER	na
appellerions	VER	na
appela	VER	na
appelaient	VER	na
appelais	VER	na
appelait	VER	na
appelés	VER	m
appelées	VER	f
appelée	VER	f
appelé	VER	m
appelèrent	VER	na
appelât	VER	na
appelons	VER	na
appelles	VER	na
appelleront	VER	na
appelai	VER	na
appelleriez	VER	na
appellera	VER	na
appelant	VER	na
appeler	VER	na
appelez	VER	na
appeliez	VER	na
appelions	VER	na
appelle	VER	na
appellent	VER	na
appellerai	VER	na
appelleraient	VER	na
appellerais	VER	na
appellerait	VER	na
appelleras	VER	na
appellerez	VER	na
est-ce que	ADV	na
hommes	NOM	m
homme	NOM	m
partîmes	VER	na
partît	VER	na
partiriez	VER	na
partirions	VER	na
partez	VER	na
partirez	VER	na
partirons	VER	na
partirent	VER	na
partirait	VER	na
partirais	VER	na
partiraient	VER	na
partirai	VER	na
partir	VER	na
partions	VER	na
partiez	VER	na
parties	VER	f
partie	VER	f
parti	VER	m
partiront	VER	na
pars	VER	na
partis	VER	m
partisse	VER	na
partes	VER	na
partissent	VER	na
partit	VER	na
partons	VER	na
partent	VER	na
parte	VER	na
partant	VER	na
partait	VER	na
partais	VER	na
partaient	VER	na
part	VER	na
partira	VER	na
partiras	VER	na
petite	ADJ	f
petites	ADJ	f
petits	ADJ	m
petit	ADJ	m
mes	ADJ:pos	na
la	PRO:per	f
toujours	ADV	na
jour	NOM	m
jours	NOM	m
tout	ADV	na
femmes	NOM	f
femme	NOM	f
temps	NOM	m
maintenant	ADV	na
notre	ADJ:pos	na
vies	NOM	f
vie	NOM	f
deux	ADJ:num	na
mettrai	VER	na
mets	VER	na
mettras	VER	na
mettaient	VER	na
mettais	VER	na
mettait	VER	na
mettraient	VER	na
mettant	VER	na
mît	VER	na
mîmes	VER	na
mettre	VER	na
mettrais	VER	na
mette	VER	na
mettra	VER	na
mettons	VER	na
mettions	VER	na
mettiez	VER	na
mettez	VER	na
mettront	VER	na
mettes	VER	na
mettriez	VER	na
mettrez	VER	na
mettent	VER	na
mises	VER	f
mettrions	VER	na
mise	VER	f
mirent	VER	na
missent	VER	na
missions	VER	na
mettrons	VER	na
mis	VER	m
mit	VER	na
met	VER	na
mettrait	VER	na
resta	VER	na
restassent	VER	na
restant	VER	na
restait	VER	na
restai	VER	na
restées	VER	f
restée	VER	f
resté	VER	m
restèrent	VER	na
regretter	VER	na
restâmes	VER	na
restaient	VER	na
restés	VER	m
restera	VER	na
resterai	VER	na
reste	VER	na
resteraient	VER	na
resterais	VER	na
resterait	VER	na
resteras	VER	na
resterez	VER	na
resteriez	VER	na
resterions	VER	na
rester	VER	na
resteront	VER	na
restes	VER	na
restez	VER	na
restiez	VER	na
restent	VER	na
restions	VER	na
restons	VER	na
resterons	VER	na
restât	VER	na
restais	VER	na
sans	PRE	na
arrêtât	VER	na
arrêteraient	VER	na
arrêterai	VER	na
arrêtera	VER	na
arrêter	VER	na
arrêtent	VER	na
arrête	VER	na
arrêtassent	VER	na
arrêtons	VER	na
arrêtâmes	VER	na
arrêtèrent	VER	na
arrêterait	VER	na
arrêté	VER	m
arrêtée	VER	f
arrêtiez	VER	na
arrêta	VER	na
arrêtées	VER	f
arrêtant	VER	na
arrêtai	VER	na
arrêtés	VER	m
arrêtaient	VER	na
arrêtais	VER	na
arrêterais	VER	na
arrêtait	VER	na
arrêterez	VER	na
arrêteriez	VER	na
arrêterions	VER	na
arrêterons	VER	na
arrêteront	VER	na
arrêteras	VER	na
arrêtions	VER	na
arrêtes	VER	na
arrêtez	VER	na
vraiment	ADV	na
connaîtrai	VER	na
connaissez	VER	na
connaissons	VER	na
connaîtraient	VER	na
connais	VER	na
connût	VER	na
connûmes	VER	na
connaît	VER	na
connaîtra	VER	na
connaissaient	VER	na
connaîtrais	VER	na
connaisse	VER	na
connaîtrions	VER	na
connaissiez	VER	na
connaîtrez	VER	na
connaisses	VER	na
connaître	VER	na
connaissent	VER	na
connaissions	VER	na
connaîtriez	VER	na
connaîtras	VER	na
connaissant	VER	na
connaîtrait	VER	na
connaîtront	VER	na
connaissait	VER	na
connaissais	VER	na
connaîtrons	VER	na
connussent	VER	na
connusses	VER	na
connut	VER	na
connurent	VER	na
connusse	VER	na
connues	VER	f
connus	VER	m
connu	VER	m
connue	VER	f
sûrs	ADJ	m
sûr	ADJ	m
sûre	ADJ	f
sûres	ADJ	f
merci	ONO	na
tuée	VER	f
tuant	VER	na
tuaient	VER	na
tuons	VER	na
tueras	VER	na
tuent	VER	na
tue	VER	na
tuai	VER	na
tuerions	VER	na
tuais	VER	na
tuera	VER	na
tua	VER	na
tuèrent	VER	na
tuions	VER	na
tuiez	VER	na
tues	VER	na
tuerai	VER	na
tuerais	VER	na
tueriez	VER	na
tuât	VER	na
tuerait	VER	na
tuerez	VER	na
tué	VER	m
tueront	VER	na
tuerons	VER	na
tués	VER	m
tuer	VER	na
tuez	VER	na
tuait	VER	na
tuas	VER	na
tuées	VER	f
quoi	PRO:int	na
quoi	PRO:rel	na
comment	ADV	na
mourrions	VER	na
mourant	VER	na
mouraient	VER	na
mourrez	VER	na
mourais	VER	na
meurs	VER	na
meurt	VER	na
mourrait	VER	na
mourez	VER	na
meures	VER	na
mourir	VER	na
mourait	VER	na
mourra	VER	na
mourrai	VER	na
mourront	VER	na
mourraient	VER	na
mourrais	VER	na
mourrons	VER	na
mort	VER	m
meure	VER	na
morte	VER	f
mortes	VER	f
meurent	VER	na
mourras	VER	na
morts	VER	m
mourions	VER	na
mouriez	VER	na
mourons	VER	na
mourussent	VER	na
moururent	VER	na
mourus	VER	na
mourriez	VER	na
mourut	VER	na
mourûtes	VER	na
mourût	VER	na
demanderai	VER	na
demandions	VER	na
demandiez	VER	na
demander	VER	na
demandes	VER	na
demandez	VER	na
demande	VER	na
demanderont	VER	na
demanderons	VER	na
demanderiez	VER	na
demandent	VER	na
demandâmes	VER	na
demandons	VER	na
demandant	VER	na
demandât	VER	na
demandèrent	VER	na
demandait	VER	na
demandé	VER	m
demandée	VER	f
demandées	VER	f
demandés	VER	m
demanda	VER	na
demandais	VER	na
demandaient	VER	na
demanderez	VER	na
demandai	VER	na
demandera	VER	na
demanderaient	VER	na
demanderais	VER	na
demanderait	VER	na
demanderas	VER	na
même	ADV	na
peut-être	ADV	na
dieux	NOM	m
dieu	NOM	m
fois	NOM	f
oh	ONO	na
père	NOM	m
pères	NOM	m
peu	NOM	m
comprendrait	VER	na
comprendrais	VER	na
comprendras	VER	na
comprendraient	VER	na
comprendrai	VER	na
comprendre	VER	na
comprendra	VER	na
comprendrez	VER	na
comprend	VER	na
comprisse	VER	na
comprenant	VER	na
comprenait	VER	na
comprennes	VER	na
comprennent	VER	na
comprenais	VER	na
comprises	VER	f
comprenaient	VER	na
comprirent	VER	na
compris	VER	m
comprît	VER	na
comprendront	VER	na
comprendrons	VER	na
comprise	VER	f
comprîmes	VER	na
comprit	VER	na
comprends	VER	na
comprenez	VER	na
compreniez	VER	na
comprenions	VER	na
comprenons	VER	na
comprendrions	VER	na
comprendriez	VER	na
comprenne	VER	na
seules	ADJ	f
seul	ADJ	m
seuls	ADJ	m
seule	ADJ	f
quelque	ADJ:ind	na
sortirais	VER	na
sortirez	VER	na
sortaient	VER	na
sortîmes	VER	na
sort	VER	na
sortiez	VER	na
sortirai	VER	na
sortait	VER	na
sortirons	VER	na
sortirions	VER	na
sortez	VER	na
sortirait	VER	na
sortiraient	VER	na
sortiras	VER	na
sortons	VER	na
sortiriez	VER	na
sorties	VER	f
sorti	VER	m
sorte	VER	na
sortira	VER	na
sors	VER	na
sortît	VER	na
sortais	VER	na
sortiront	VER	na
sortes	VER	na
sortions	VER	na
sortir	VER	na
sortent	VER	na
sortis	VER	m
sortie	VER	f
sortit	VER	na
sortant	VER	na
sortirent	VER	na
ans	NOM	m
an	NOM	m
s'	CON	na
trop	ADV	na
chez	PRE	na
filles	NOM	f
fille	NOM	f
aux	ART:def	na
monde	NOM	m
mondes	NOM	m
vrai	ADJ	m
vrais	ADJ	m
vraie	ADJ	f
vraies	ADJ	f
autres	ADJ	na
autre	ADJ	na
besoins	NOM	m
besoin	NOM	m
accords	NOM	m
accord	NOM	m
ses	ADJ:pos	na
amie	NOM	f
amies	NOM	f
amis	NOM	m
ami	NOM	m
monsieur	NOM	m
messieurs	NOM	m
enfant	NOM	na
enfants	NOM	m
entendues	VER	f
entendras	VER	na
entendra	VER	na
entendrai	VER	na
entendraient	VER	na
entendrais	VER	na
entendrait	VER	na
entendront	VER	na
entendre	VER	na
entendu	VER	m
entendrez	VER	na
entendons	VER	na
entendriez	VER	na
entends	VER	na
entendît	VER	na
entendîmes	VER	na
entendrions	VER	na
entendrons	VER	na
entendus	VER	m
entendisse	VER	na
entendue	VER	f
entendit	VER	na
entendes	VER	na
entend	VER	na
entendaient	VER	na
entendais	VER	na
entendait	VER	na
entendissent	VER	na
entende	VER	na
entendent	VER	na
entendant	VER	na
entendez	VER	na
entendions	VER	na
entendirent	VER	na
entendis	VER	na
entendiez	VER	na
voilà	PRE	na
cherchera	VER	na
cherchent	VER	na
cherche	VER	na
chercher	VER	na
chercherai	VER	na
cherchas	VER	na
cherchant	VER	na
cherchait	VER	na
cherchais	VER	na
chercha	VER	na
cherchai	VER	na
cherchaient	VER	na
cherchez	VER	na
chercheraient	VER	na
cherchiez	VER	na
chercheriez	VER	na
chercherions	VER	na
chercherons	VER	na
chercheront	VER	na
cherchées	VER	f
cherches	VER	na
cherchions	VER	na
chercheras	VER	na
cherchons	VER	na
cherchâmes	VER	na
cherchât	VER	na
cherchèrent	VER	na
cherché	VER	m
cherchés	VER	m
chercherez	VER	na
cherchée	VER	f
chercherait	VER	na
chercherais	VER	na
heures	NOM	f
heure	NOM	f
tes	ADJ:pos	na
aidée	VER	f
aides	VER	na
aidées	VER	f
aiderais	VER	na
aidez	VER	na
aidés	VER	m
aidé	VER	m
aideraient	VER	na
aidions	VER	na
aidera	VER	na
aider	VER	na
aident	VER	na
aiderez	VER	na
aiderai	VER	na
aidiez	VER	na
aide	VER	na
aideras	VER	na
aidait	VER	na
aidèrent	VER	na
aidai	VER	na
aideriez	VER	na
aida	VER	na
aiderions	VER	na
aidât	VER	na
aiderait	VER	na
aidant	VER	na
aidaient	VER	na
aidons	VER	na
aidais	VER	na
aidassent	VER	na
aideront	VER	na
aiderons	VER	na
mère	NOM	f
mères	NOM	f
déjà	ADV	na
belle	ADJ	f
beau	ADJ	m
belles	ADJ	f
beaux	ADJ	m
essayés	VER	m
essayeraient	VER	na
essayé	VER	m
essaierez	VER	na
essaies	VER	na
essaieront	VER	na
essayeras	VER	na
essayerez	VER	na
essayerais	VER	na
essayeriez	VER	na
essayerons	VER	na
essayeront	VER	na
essayais	VER	na
essayes	VER	na
essayez	VER	na
essayant	VER	na
essayiez	VER	na
essaierons	VER	na
essaye	VER	na
essayent	VER	na
essayer	VER	na
essayera	VER	na
essaie	VER	na
essayait	VER	na
essaieras	VER	na
essayées	VER	f
essayions	VER	na
essayerait	VER	na
essaierait	VER	na
essayâmes	VER	na
essaierais	VER	na
essaieraient	VER	na
essayèrent	VER	na
essaya	VER	na
essayât	VER	na
essaierai	VER	na
essayée	VER	f
essayaient	VER	na
essaiera	VER	na
essayons	VER	na
essayerai	VER	na
essaieriez	VER	na
essaierions	VER	na
essayai	VER	na
essaient	VER	na
quel	ADJ:int	m
juste	ADJ	na
justes	ADJ	na
pourquoi	CON	na
mieux	ADV	na
vos	ADJ:pos	na
grandes	ADJ	f
grande	ADJ	f
grands	ADJ	m
grand	ADJ	m
quelqu'un	PRO:ind	na
beaucoup	ADV	na
revînt	VER	na
revenaient	VER	na
revint	VER	na
revinssent	VER	na
reveniez	VER	na
revins	VER	na
revenait	VER	na
reviendrez	VER	na
reviendras	VER	na
reviendrait	VER	na
reviendraient	VER	na
reviendrai	VER	na
reviendra	VER	na
revenais	VER	na
revenant	VER	na
reviendrions	VER	na
revenus	VER	m
revenues	VER	f
revenue	VER	f
revenez	VER	na
revenu	VER	m
revenons	VER	na
revenir	VER	na
reviendriez	VER	na
reviendrais	VER	na
reviendrons	VER	na
reviennes	VER	na
revenions	VER	na
reviendront	VER	na
revient	VER	na
reviens	VER	na
revinrent	VER	na
reviennent	VER	na
revienne	VER	na
donc	CON	na
plairaient	VER	na
plaisait	VER	na
plaire	VER	na
plairais	VER	na
plaises	VER	na
plaisaient	VER	na
plaisant	VER	na
plaisent	VER	na
plaise	VER	na
plaisais	VER	na
plût	VER	na
plais	VER	na
plut	VER	na
plairont	VER	na
plaisez	VER	na
plaisions	VER	na
plairiez	VER	na
plairez	VER	na
plaira	VER	na
plaisiez	VER	na
plairai	VER	na
plaisons	VER	na
plurent	VER	na
plairas	VER	na
plairait	VER	na
plus	VER	na
plusse	VER	na
plaît	VER	na
maison	NOM	na
maisons	NOM	f
gens	NOM	na
après	PRE	na
nuit	NOM	f
nuits	NOM	f
comme	ADV	na
personne	PRO:ind	m
ah	ONO	na
soir	NOM	m
soirs	NOM	m
nom	NOM	m
noms	NOM	m
bonjours	NOM	m
bonjour	NOM	m
joueraient	VER	na
jouait	VER	na
jouerais	VER	na
jouerai	VER	na
jouera	VER	na
jouer	VER	na
jouions	VER	na
jouées	VER	f
jouerait	VER	na
joués	VER	m
jouez	VER	na
joue	VER	na
jouée	VER	f
joué	VER	m
jouons	VER	na
jouèrent	VER	na
joueras	VER	na
jouât	VER	na
jouent	VER	na
jouiez	VER	na
jouant	VER	na
jouâmes	VER	na
joueriez	VER	na
jouerions	VER	na
jouerez	VER	na
jouais	VER	na
jouaient	VER	na
jouai	VER	na
jouerons	VER	na
joueront	VER	na
joua	VER	na
joues	VER	na
comment	CON	na
finiraient	VER	na
finîmes	VER	na
finirai	VER	na
finissons	VER	na
finira	VER	na
finir	VER	na
finirais	VER	na
finit	VER	na
fini	VER	m
finirait	VER	na
finissions	VER	na
finissiez	VER	na
finît	VER	na
finies	VER	f
finie	VER	f
finisses	VER	na
finisse	VER	na
finissais	VER	na
finirez	VER	na
finirions	VER	na
finirons	VER	na
finiront	VER	na
finis	VER	m
finissez	VER	na
finissaient	VER	na
finiriez	VER	na
finiras	VER	na
finissait	VER	na
finissant	VER	na
finirent	VER	na
finissent	VER	na
peur	NOM	f
peurs	NOM	f
un	PRO:ind	m
parce que	CON	na
perd	VER	na
perdais	VER	na
perdaient	VER	na
perdons	VER	na
perdait	VER	na
perdus	VER	m
perdront	VER	na
perds	VER	na
perdant	VER	na
perdrions	VER	na
perdu	VER	m
perdue	VER	f
perdues	VER	f
perdriez	VER	na
perdrez	VER	na
perdre	VER	na
perdras	VER	na
perdrait	VER	na
perdrais	VER	na
perdraient	VER	na
perdîmes	VER	na
perdrai	VER	na
perdra	VER	na
perdît	VER	na
perdit	VER	na
perdisse	VER	na
perdis	VER	na
perdirent	VER	na
perdions	VER	na
perdiez	VER	na
perdez	VER	na
perdes	VER	na
perdent	VER	na
perde	VER	na
perdrons	VER	na
maman	NOM	f
mamans	NOM	f
sentis	VER	m
sentie	VER	f
sentirez	VER	na
sentiriez	VER	na
sentiras	VER	na
sentes	VER	na
sentons	VER	na
sentiez	VER	na
senties	VER	f
sentirait	VER	na
sentions	VER	na
sentir	VER	na
sentiront	VER	na
sentissent	VER	na
sentisse	VER	na
sentirais	VER	na
senti	VER	m
sentirons	VER	na
sentiraient	VER	na
sentirai	VER	na
sentira	VER	na
sentez	VER	na
sentit	VER	na
sentirent	VER	na
sentaient	VER	na
sente	VER	na
sentît	VER	na
sens	VER	na
sent	VER	na
sentais	VER	na
sentait	VER	na
sentant	VER	na
sentîmes	VER	na
sentent	VER	na
ouais	ADV	na
rentre	VER	na
rentrai	VER	na
rentra	VER	na
rentrerez	VER	na
rentrèrent	VER	na
rentreras	VER	na
rentré	VER	m
rentrerait	VER	na
rentrerais	VER	na
rentreraient	VER	na
rentrée	VER	f
rentrées	VER	f
rentraient	VER	na
rentrant	VER	na
rentrés	VER	m
rentrerai	VER	na
rentrâmes	VER	na
rentrera	VER	na
rentrer	VER	na
rentrent	VER	na
rentrais	VER	na
rentrait	VER	na
rentrerons	VER	na
rentrât	VER	na
rentrons	VER	na
rentrez	VER	na
rentrerions	VER	na
rentreriez	VER	na
rentres	VER	na
rentrions	VER	na
rentreront	VER	na
rentriez	VER	na
avant	PRE	na
nos	ADJ:pos	na
bon	ONO	na
problème	NOM	m
problèmes	NOM	m
argent	NOM	m
argents	NOM	m
quelle	ADJ:int	f
vivraient	VER	na
vivre	VER	na
vivras	VER	na
vivrez	VER	na
vivriez	VER	na
vivrons	VER	na
vivrait	VER	na
vive	VER	na
vécu	VER	m
vivrais	VER	na
vivent	VER	na
vivrai	VER	na
vit	VER	na
vivra	VER	na
vivront	VER	na
vivaient	VER	na
vivais	VER	na
vivait	VER	na
vivions	VER	na
viviez	VER	na
vivant	VER	na
vivez	VER	na
vives	VER	na
vivrions	VER	na
vivons	VER	na
vécue	VER	f
vécus	VER	m
vécussent	VER	na
vécut	VER	na
vécûmes	VER	na
vis	VER	na
vécues	VER	f
vécût	VER	na
vécurent	VER	na
rendiez	VER	na
rendons	VER	na
rendraient	VER	na
rendrai	VER	na
rendra	VER	na
rendus	VER	m
rendîmes	VER	na
rendais	VER	na
rendit	VER	na
rendît	VER	na
rendissent	VER	na
rendisse	VER	na
rendis	VER	na
rendirent	VER	na
rendions	VER	na
rendez	VER	na
rendes	VER	na
rendues	VER	f
rendent	VER	na
rendrais	VER	na
rendrez	VER	na
rendras	VER	na
rendrait	VER	na
rendait	VER	na
rendriez	VER	na
rend	VER	na
rendrons	VER	na
rendant	VER	na
rendront	VER	na
rende	VER	na
rendue	VER	f
rends	VER	na
rendu	VER	m
rendaient	VER	na
rendre	VER	na
tiendrais	VER	na
tenus	VER	m
tenues	VER	f
tenir	VER	na
tînt	VER	na
tînmes	VER	na
tiendraient	VER	na
tiendrai	VER	na
tenons	VER	na
tiendra	VER	na
tint	VER	na
tenu	VER	m
tinrent	VER	na
tenais	VER	na
tenaient	VER	na
tinssent	VER	na
tins	VER	na
tiendrait	VER	na
tiendront	VER	na
tenions	VER	na
tienne	VER	na
tiendrez	VER	na
tiennent	VER	na
teniez	VER	na
tiennes	VER	na
tiendras	VER	na
tenue	VER	f
tenez	VER	na
tiendriez	VER	na
tiendrons	VER	na
tenant	VER	na
tient	VER	na
tiens	VER	na
tenait	VER	na
cet	ADJ:dem	m
mains	NOM	f
main	NOM	na
cela	PRO:dem	na
vite	ADV	na
oublierai	VER	na
oubliera	VER	na
oublier	VER	na
oublieraient	VER	na
oublient	VER	na
oublie	VER	na
oublierais	VER	na
oubliasse	VER	na
oubliés	VER	m
oublierait	VER	na
oubliions	VER	na
oubliée	VER	f
oublié	VER	m
oublièrent	VER	na
oubliât	VER	na
oubliâmes	VER	na
oublions	VER	na
oubliiez	VER	na
oublieras	VER	na
oubliez	VER	na
oublies	VER	na
oublieront	VER	na
oubliées	VER	f
oublierons	VER	na
oublierez	VER	na
oublias	VER	na
oublierions	VER	na
oubliai	VER	na
oubliaient	VER	na
oubliais	VER	na
oubliait	VER	na
oubliant	VER	na
oublia	VER	na
airs	NOM	m
air	NOM	m
depuis	PRE	na
fils	NOM	m
travaillait	VER	na
travaillerions	VER	na
travaillaient	VER	na
travaillant	VER	na
travaillerons	VER	na
travaillerez	VER	na
travaillais	VER	na
travaillera	VER	na
travailleront	VER	na
travaillerai	VER	na
travailleraient	VER	na
travaille	VER	na
travailles	VER	na
travaillât	VER	na
travaillez	VER	na
travaillai	VER	na
travailla	VER	na
travaillèrent	VER	na
travaillerais	VER	na
travaillé	VER	m
travaillerait	VER	na
travaillée	VER	f
travailleras	VER	na
travaillées	VER	f
travailler	VER	na
travaillés	VER	m
travaillâmes	VER	na
travaillons	VER	na
travaillions	VER	na
travailliez	VER	na
travaillent	VER	na
travaillassent	VER	na
travailleriez	VER	na
moins	ADV	na
têtes	NOM	f
tête	NOM	f
autre	PRO:ind	na
coup	NOM	m
coups	NOM	m
écouter	VER	na
écoutés	VER	m
écouteras	VER	na
écouterai	VER	na
écoutiez	VER	na
écouterait	VER	na
écoutes	VER	na
écoutez	VER	na
écoutai	VER	na
écouterais	VER	na
écouteront	VER	na
écouterez	VER	na
écouterons	VER	na
écouta	VER	na
écouteraient	VER	na
écoutions	VER	na
écoutât	VER	na
écoutera	VER	na
écoutèrent	VER	na
écouté	VER	m
écoutent	VER	na
écoute	VER	na
écoutant	VER	na
écoutées	VER	f
écoutait	VER	na
écouteriez	VER	na
écoutée	VER	f
écoutais	VER	na
écoutaient	VER	na
écoutâmes	VER	na
écoutons	VER	na
raisons	NOM	f
raison	NOM	f
mangerons	VER	na
mangée	VER	f
mangèrent	VER	na
mangions	VER	na
mangées	VER	f
mangez	VER	na
mangeâmes	VER	na
manges	VER	na
mangerions	VER	na
mangés	VER	m
mangiez	VER	na
mangeront	VER	na
manger	VER	na
mangeât	VER	na
mangeons	VER	na
mangé	VER	m
mangerez	VER	na
mangeaient	VER	na
mangeais	VER	na
mangeant	VER	na
mangeas	VER	na
mangeriez	VER	na
mangeasse	VER	na
mangeras	VER	na
mangea	VER	na
mangerait	VER	na
mangerais	VER	na
mangeraient	VER	na
mangerai	VER	na
mangera	VER	na
mangent	VER	na
mangeai	VER	na
mangeait	VER	na
mange	VER	na
mortes	NOM	f
mort	NOM	na
morts	NOM	na
morte	NOM	f
amours	NOM	na
amour	NOM	m
mal	ADV	na
entreront	VER	na
entrer	VER	na
entrée	VER	f
entrerons	VER	na
entrent	VER	na
entrerions	VER	na
entrions	VER	na
entrerai	VER	na
entrerait	VER	na
entriez	VER	na
entrerais	VER	na
entreras	VER	na
entreraient	VER	na
entrai	VER	na
entrera	VER	na
entrées	VER	f
entrât	VER	na
entrâmes	VER	na
entré	VER	m
entrant	VER	na
entrais	VER	na
entrons	VER	na
entrait	VER	na
entra	VER	na
entres	VER	na
entrerez	VER	na
entrez	VER	na
entraient	VER	na
entrèrent	VER	na
engraisser	VER	na
entrassent	VER	na
entrés	VER	m
entre	VER	na
deviendrez	VER	na
devinssiez	VER	na
deviens	VER	na
devinsse	VER	na
devienne	VER	na
deviendriez	VER	na
deviendront	VER	na
devint	VER	na
deviendrions	VER	na
devient	VER	na
devins	VER	na
devinrent	VER	na
deviendrons	VER	na
deviendrais	VER	na
devinssent	VER	na
devenus	VER	m
devenait	VER	na
deviendraient	VER	na
deviendrai	VER	na
deviendra	VER	na
deviendras	VER	na
devenues	VER	f
devenue	VER	f
devenu	VER	m
devenons	VER	na
devenions	VER	na
deveniez	VER	na
devenez	VER	na
devenant	VER	na
devenir	VER	na
deviendrait	VER	na
devenais	VER	na
deviennes	VER	na
deviennent	VER	na
devînt	VER	na
devînmes	VER	na
devenaient	VER	na
hein	ONO	na
commenceront	VER	na
commençai	VER	na
commenceras	VER	na
commençaient	VER	na
commençais	VER	na
commençait	VER	na
commençant	VER	na
commenças	VER	na
commençâmes	VER	na
commencerions	VER	na
commençons	VER	na
commencerons	VER	na
commençât	VER	na
commenceriez	VER	na
commencerez	VER	na
commencerais	VER	na
commencerait	VER	na
commencées	VER	f
commenceraient	VER	na
commenciez	VER	na
commencerai	VER	na
commencée	VER	f
commencera	VER	na
commences	VER	na
commença	VER	na
commencer	VER	na
commencent	VER	na
commencèrent	VER	na
commence	VER	na
commencés	VER	m
commencez	VER	na
commencé	VER	m
commencions	VER	na
moment	NOM	m
moments	NOM	m
dernières	ADJ	f
derniers	ADJ	m
dernier	ADJ	m
dernière	ADJ	f
voiture	NOM	na
voitures	NOM	f
demain	ADV	na
elles	PRO:per	f
payeront	VER	na
payera	VER	na
payé	VER	m
payons	VER	na
payerons	VER	na
payait	VER	na
payant	VER	na
paient	VER	na
payassent	VER	na
payassiez	VER	na
paye	VER	na
payent	VER	na
payer	VER	na
payerai	VER	na
paie	VER	na
payés	VER	m
payâmes	VER	na
payées	VER	f
payée	VER	f
payeraient	VER	na
payeriez	VER	na
payerez	VER	na
payes	VER	na
paies	VER	na
paieront	VER	na
paierons	VER	na
paierions	VER	na
payions	VER	na
paierais	VER	na
paierai	VER	na
payez	VER	na
paieras	VER	na
paierez	VER	na
paiera	VER	na
payât	VER	na
payeras	VER	na
payèrent	VER	na
paieriez	VER	na
payerais	VER	na
payiez	VER	na
paierait	VER	na
paya	VER	na
payai	VER	na
payais	VER	na
payaient	VER	na
payerait	VER	na
paieraient	VER	na
tirerais	VER	na
tirez	VER	na
tireras	VER	na
tires	VER	na
tirerez	VER	na
tireraient	VER	na
tireriez	VER	na
tirerions	VER	na
tirerons	VER	na
tiriez	VER	na
tireront	VER	na
tirerait	VER	na
tirions	VER	na
tirés	VER	m
tiraient	VER	na
tiré	VER	m
tira	VER	na
tirées	VER	f
tirons	VER	na
tirâmes	VER	na
tirai	VER	na
tirais	VER	na
tirer	VER	na
tirèrent	VER	na
tirait	VER	na
tirant	VER	na
tirât	VER	na
tiras	VER	na
tirée	VER	f
tirent	VER	na
tire	VER	na
tirerai	VER	na
tirera	VER	na
ouvres	VER	na
ouvrirent	VER	na
ouvrît	VER	na
ouvrira	VER	na
ouvrirons	VER	na
ouvririons	VER	na
ouvririez	VER	na
ouvrirez	VER	na
ouvrirai	VER	na
ouvriras	VER	na
ouvrissent	VER	na
ouverts	VER	m
ouvrirait	VER	na
ouvertes	VER	f
ouverte	VER	f
ouvert	VER	m
ouvrirais	VER	na
ouvriraient	VER	na
ouvris	VER	na
ouvriront	VER	na
ouvrit	VER	na
ouvrant	VER	na
ouvrir	VER	na
ouvrions	VER	na
ouvriez	VER	na
ouvrez	VER	na
ouvrîmes	VER	na
ouvre	VER	na
ouvrent	VER	na
ouvrait	VER	na
ouvrais	VER	na
ouvraient	VER	na
ouvrons	VER	na
yeux	NOM	m
oeil	NOM	m
oeils	NOM	m
fait	NOM	m
faits	NOM	m
changèrent	VER	na
changions	VER	na
changez	VER	na
changeâmes	VER	na
changeât	VER	na
changes	VER	na
changeraient	VER	na
changé	VER	m
changeront	VER	na
changera	VER	na
changer	VER	na
changeons	VER	na
changerais	VER	na
changent	VER	na
changeas	VER	na
changeant	VER	na
changeait	VER	na
changeais	VER	na
changeaient	VER	na
changeai	VER	na
changea	VER	na
changées	VER	f
changés	VER	m
change	VER	na
changerai	VER	na
changeras	VER	na
changerez	VER	na
changeriez	VER	na
changerons	VER	na
changée	VER	f
changerait	VER	na
changiez	VER	na
questions	NOM	f
question	NOM	f
tombera	VER	na
tomberai	VER	na
tombe	VER	na
tomberaient	VER	na
tomberais	VER	na
tombant	VER	na
tomberait	VER	na
tomber	VER	na
tomberas	VER	na
tombèrent	VER	na
tombait	VER	na
tombais	VER	na
tombé	VER	m
tomberez	VER	na
tombaient	VER	na
tombée	VER	f
tombâmes	VER	na
tomberiez	VER	na
tombai	VER	na
tombes	VER	na
tomba	VER	na
tomberont	VER	na
tombez	VER	na
tombions	VER	na
tombons	VER	na
tombât	VER	na
tombiez	VER	na
tomberons	VER	na
tomberions	VER	na
tombés	VER	m
tombées	VER	f
tombent	VER	na
assez	ADV	na
même	ADJ	na
mêmes	ADJ	na
foutiez	VER	na
foutre	VER	na
foutant	VER	na
foutus	VER	m
foutrai	VER	na
foutraient	VER	na
foutrais	VER	na
foute	VER	na
foutrait	VER	na
foutras	VER	na
foutrez	VER	na
foutit	VER	na
foutrons	VER	na
foutront	VER	na
foutez	VER	na
foutes	VER	na
foutu	VER	m
foutent	VER	na
foutue	VER	f
foutues	VER	f
foutions	VER	na
foutait	VER	na
fous	VER	na
foutra	VER	na
foutît	VER	na
fout	VER	na
foutais	VER	na
foutons	VER	na
foutaient	VER	na
excuser	VER	na
excusée	VER	f
excuseront	VER	na
excuseriez	VER	na
excuseras	VER	na
excuse	VER	na
excusera	VER	na
excusais	VER	na
excusaient	VER	na
excusées	VER	f
excusiez	VER	na
excusai	VER	na
excuserez	VER	na
excusa	VER	na
excusons	VER	na
excusés	VER	m
excuserait	VER	na
excuserai	VER	na
excusions	VER	na
excuserais	VER	na
excusé	VER	m
excuserons	VER	na
excusait	VER	na
excuses	VER	na
excusant	VER	na
excusez	VER	na
excusâmes	VER	na
excusât	VER	na
excusèrent	VER	na
excusent	VER	na
affaire	NOM	f
affaires	NOM	f
dormît	VER	na
dors	VER	na
dormiraient	VER	na
dormaient	VER	na
dormais	VER	na
dort	VER	na
dormirais	VER	na
dormait	VER	na
dorme	VER	na
dormirait	VER	na
dormez	VER	na
dormions	VER	na
dormant	VER	na
dormir	VER	na
dormiras	VER	na
dormirent	VER	na
dormirez	VER	na
dormiriez	VER	na
dormirions	VER	na
dormirons	VER	na
dormiez	VER	na
dormiront	VER	na
dormis	VER	na
dormirai	VER	na
dormi	VER	m
dormit	VER	na
dormira	VER	na
dormons	VER	na
dormes	VER	na
dormîmes	VER	na
dorment	VER	na
combien	ADV	na
frères	NOM	m
frère	NOM	m
travail	NOM	m
travaux	NOM	m
idée	NOM	f
idées	NOM	f
eh	ONO	na
famille	NOM	f
familles	NOM	f
trucs	NOM	m
truc	NOM	m
trois	ADJ:num	na
tant	ADV	na
mercis	NOM	m
merci	NOM	na
ni	CON	na
première	ADJ	f
premier	ADJ	m
premiers	ADJ	m
premières	ADJ	f
tous	PRO:ind	m
occupés	VER	m
occuperai	VER	na
occupa	VER	na
occupas	VER	na
occupaient	VER	na
occupais	VER	na
occupées	VER	f
occuperaient	VER	na
occuperais	VER	na
occupée	VER	f
occupai	VER	na
occupé	VER	m
occuperas	VER	na
occupions	VER	na
occupiez	VER	na
occupez	VER	na
occupes	VER	na
occupèrent	VER	na
occuperont	VER	na
occuperons	VER	na
occuperions	VER	na
occupât	VER	na
occupons	VER	na
occuperait	VER	na
occuperez	VER	na
occupera	VER	na
occupe	VER	na
occupait	VER	na
occuper	VER	na
occupant	VER	na
occupent	VER	na
entre	PRE	na
marches	VER	na
marcheras	VER	na
marchez	VER	na
marcherait	VER	na
marchiez	VER	na
marchait	VER	na
marchai	VER	na
marchent	VER	na
marchions	VER	na
marcher	VER	na
marcherez	VER	na
marcheront	VER	na
marchera	VER	na
marcherai	VER	na
marche	VER	na
marcha	VER	na
marcherais	VER	na
marcheraient	VER	na
marchés	VER	m
marchées	VER	f
marché	VER	m
marcherions	VER	na
marcheriez	VER	na
marchèrent	VER	na
marchaient	VER	na
marchant	VER	na
marchais	VER	na
marchât	VER	na
marchâmes	VER	na
marcherons	VER	na
marchons	VER	na
chance	NOM	na
chances	NOM	f
aujourd'hui	ADV	na
envoyons	VER	na
envoyée	VER	f
envoyèrent	VER	na
envoyâmes	VER	na
envoyées	VER	f
envoyés	VER	m
envoyions	VER	na
envoyât	VER	na
envoyé	VER	m
envoyaient	VER	na
envoyiez	VER	na
enverrais	VER	na
envoya	VER	na
envoyai	VER	na
envoyais	VER	na
envoyait	VER	na
envoyez	VER	na
enverrai	VER	na
enverraient	VER	na
enverront	VER	na
envoient	VER	na
enverrons	VER	na
enverrions	VER	na
enverriez	VER	na
enverrez	VER	na
enverras	VER	na
enverrait	VER	na
envoyant	VER	na
envoie	VER	na
enverra	VER	na
envoyer	VER	na
envoies	VER	na
histoire	NOM	f
histoires	NOM	f
tard	ADV	na
apprennes	VER	na
apprendra	VER	na
apprend	VER	na
apprenant	VER	na
apprirent	VER	na
apprenais	VER	na
apprenaient	VER	na
apprit	VER	na
apprenons	VER	na
apprennent	VER	na
apprissent	VER	na
apprises	VER	f
apprise	VER	f
appris	VER	m
apprenez	VER	na
apprendrai	VER	na
appreniez	VER	na
apprenait	VER	na
apprenne	VER	na
apprendraient	VER	na
apprends	VER	na
apprendrais	VER	na
apprendrait	VER	na
apprendront	VER	na
apprenions	VER	na
apprît	VER	na
apprendras	VER	na
apprendre	VER	na
apprendrons	VER	na
apprîmes	VER	na
apprendrions	VER	na
apprendriez	VER	na
apprendrez	VER	na
minute	NOM	f
minutes	NOM	f
buvons	VER	na
boiront	VER	na
bus	VER	m
busse	VER	na
bois	VER	na
buvais	VER	na
boive	VER	na
boit	VER	na
but	VER	na
boivent	VER	na
buvait	VER	na
buvant	VER	na
buvez	VER	na
boives	VER	na
buviez	VER	na
buvions	VER	na
buvaient	VER	na
boiras	VER	na
boira	VER	na
boire	VER	na
burent	VER	na
bûmes	VER	na
bût	VER	na
boirai	VER	na
boiraient	VER	na
boirait	VER	na
boirais	VER	na
boirez	VER	na
boiriez	VER	na
boirions	VER	na
boirons	VER	na
bu	VER	m
garder	VER	na
garderai	VER	na
gardèrent	VER	na
gardera	VER	na
gardé	VER	m
gardée	VER	f
gardaient	VER	na
gardant	VER	na
garderais	VER	na
gardais	VER	na
gardait	VER	na
gardât	VER	na
gardâmes	VER	na
garderaient	VER	na
garderont	VER	na
garderait	VER	na
garderas	VER	na
garderez	VER	na
garderiez	VER	na
garderions	VER	na
gardées	VER	f
garderons	VER	na
gardions	VER	na
gardés	VER	m
gardent	VER	na
garde	VER	na
gardiez	VER	na
gardez	VER	na
gardes	VER	na
gardons	VER	na
gardai	VER	na
garda	VER	na
quelques	ADJ:ind	na
types	NOM	m
type	NOM	m
portes	NOM	f
porte	NOM	f
tout	NOM	m
touts	NOM	m
montrées	VER	f
montrés	VER	m
montrée	VER	f
montré	VER	m
montrent	VER	na
montrèrent	VER	na
montrât	VER	na
montrâmes	VER	na
montra	VER	na
montrai	VER	na
montrais	VER	na
montrait	VER	na
montrant	VER	na
montrassent	VER	na
montre	VER	na
montre-la-moi	VER	na
montraient	VER	na
montrons	VER	na
montrerait	VER	na
montreraient	VER	na
montrions	VER	na
montrerez	VER	na
montreras	VER	na
montrerai	VER	na
montreriez	VER	na
montrerons	VER	na
montreront	VER	na
montrera	VER	na
montrer	VER	na
montres	VER	na
montrez	VER	na
montriez	VER	na
montrerais	VER	na
mal	NOM	m
maux	NOM	m
mec	NOM	m
mecs	NOM	m
assoiraient	VER	na
assoies	VER	na
assoient	VER	na
assoira	VER	na
assît	VER	na
assoirai	VER	na
asseoir	VER	na
assoyons	VER	na
assoit	VER	na
assoirais	VER	na
assoirait	VER	na
assoiras	VER	na
assoyez	VER	na
assoiront	VER	na
assois	VER	na
assoyait	VER	na
asseyaient	VER	na
assoie	VER	na
assieds	VER	na
asseyais	VER	na
assirent	VER	na
assiéra	VER	na
assiérai	VER	na
assiérais	VER	na
assiérait	VER	na
assiéras	VER	na
assiérions	VER	na
assit	VER	na
assises	VER	f
assise	VER	f
assis	VER	m
assîmes	VER	na
asseyait	VER	na
assied	VER	na
assiéront	VER	na
asseyons	VER	na
asseyions	VER	na
asseyiez	VER	na
asseyez	VER	na
asseyes	VER	na
asseyent	VER	na
asseye	VER	na
asseyant	VER	na
folles	ADJ	f
folle	ADJ	f
fou	ADJ	m
fous	ADJ	m
portons	VER	na
portes	VER	na
portera	VER	na
porterai	VER	na
porterais	VER	na
porterait	VER	na
porteras	VER	na
porterez	VER	na
porteriez	VER	na
porterons	VER	na
porteront	VER	na
portiez	VER	na
portez	VER	na
portent	VER	na
portions	VER	na
portâmes	VER	na
portât	VER	na
portèrent	VER	na
porté	VER	m
portée	VER	f
portées	VER	f
portés	VER	m
porter	VER	na
porteraient	VER	na
porte	VER	na
portais	VER	na
portassent	VER	na
porta	VER	na
portant	VER	na
portai	VER	na
portaient	VER	na
portait	VER	na
année	NOM	f
années	NOM	f
sous	PRE	na
souvenir	VER	na
souvinssent	VER	na
souviendraient	VER	na
souviendrai	VER	na
souviendra	VER	na
souvenez	VER	na
souveniez	VER	na
souvenions	VER	na
souvenus	VER	m
souviendrons	VER	na
souvenait	VER	na
souviendrait	VER	na
souvenue	VER	f
souviendras	VER	na
souvenant	VER	na
souvenons	VER	na
souviendriez	VER	na
souvenaient	VER	na
souviendrez	VER	na
souvenais	VER	na
souvenu	VER	m
souvint	VER	na
souvient	VER	na
souviendrais	VER	na
souvînt	VER	na
souvinrent	VER	na
souvienne	VER	na
souviennent	VER	na
souviennes	VER	na
souviens	VER	na
souviendront	VER	na
souvins	VER	na
prêt	ADJ	m
prêts	ADJ	na
prête	ADJ	f
prêtes	ADJ	f
contre	PRE	na
prions	VER	na
prieront	VER	na
priés	VER	m
prierez	VER	na
priées	VER	f
priée	VER	f
prierons	VER	na
pries	VER	na
priâmes	VER	na
prié	VER	m
priez	VER	na
priions	VER	na
prièrent	VER	na
prierais	VER	na
prierait	VER	na
priât	VER	na
prieraient	VER	na
prierai	VER	na
priais	VER	na
priaient	VER	na
pria	VER	na
prieras	VER	na
priera	VER	na
priai	VER	na
prier	VER	na
prient	VER	na
prie	VER	na
priasse	VER	na
priant	VER	na
priait	VER	na
pendant	PRE	na
mois	NOM	m
servais	VER	na
servions	VER	na
serviront	VER	na
servis	VER	m
servissent	VER	na
servit	VER	na
servons	VER	na
servîmes	VER	na
servît	VER	na
servir	VER	na
servirons	VER	na
servait	VER	na
serviraient	VER	na
servirait	VER	na
sers	VER	na
serviras	VER	na
servirent	VER	na
servirez	VER	na
servaient	VER	na
servant	VER	na
sert	VER	na
serve	VER	na
serviriez	VER	na
servent	VER	na
serves	VER	na
servez	VER	na
servi	VER	m
servie	VER	f
servirai	VER	na
servirions	VER	na
servira	VER	na
servies	VER	f
serviez	VER	na
servirais	VER	na
madame	NOM	f
mesdames	NOM	f
putain	NOM	f
putains	NOM	f
écririez	VER	na
écrites	VER	f
écrivant	VER	na
écrivait	VER	na
écrivais	VER	na
écrivaient	VER	na
écrits	VER	m
écrire	VER	na
écrite	VER	f
écrirons	VER	na
écrivent	VER	na
écrit	VER	m
écris	VER	na
écrirez	VER	na
écriront	VER	na
écrive	VER	na
écrivit	VER	na
écrives	VER	na
écrivez	VER	na
écrirai	VER	na
écrira	VER	na
écriraient	VER	na
écrivît	VER	na
écrivîmes	VER	na
écrivons	VER	na
écriras	VER	na
écrirait	VER	na
écrirais	VER	na
écrivisse	VER	na
écrivis	VER	na
écrivirent	VER	na
écrivions	VER	na
écriviez	VER	na
parts	NOM	f
part	NOM	na
eaux	NOM	f
eau	NOM	f
sang	NOM	m
sangs	NOM	m
place	NOM	f
places	NOM	f
espérer	VER	na
espère	VER	na
espérez	VER	na
espérées	VER	f
espérée	VER	f
espéré	VER	m
espérèrent	VER	na
espèrent	VER	na
espères	VER	na
espérât	VER	na
espérâmes	VER	na
espérons	VER	na
espérions	VER	na
espéra	VER	na
espériez	VER	na
espérai	VER	na
espéraient	VER	na
espérant	VER	na
espérait	VER	na
espérerai	VER	na
espérerais	VER	na
espérais	VER	na
espérerait	VER	na
espérés	VER	m
désola	VER	na
désolerait	VER	na
désolant	VER	na
désoleront	VER	na
désolera	VER	na
désoles	VER	na
désolez	VER	na
désolai	VER	na
désoler	VER	na
désolent	VER	na
désolât	VER	na
désole	VER	na
désolaient	VER	na
désolais	VER	na
désolait	VER	na
désolé	VER	m
désolée	VER	f
désolées	VER	f
désolés	VER	m
jeunes	ADJ	na
jeune	ADJ	na
personnes	NOM	f
personne	NOM	f
eux	PRO:per	m
retrouvaient	VER	na
retrouvât	VER	na
retrouvez	VER	na
retrouviez	VER	na
retrouvions	VER	na
retrouvons	VER	na
retrouvâmes	VER	na
retrouvèrent	VER	na
retrouva	VER	na
retrouvé	VER	m
retrouvée	VER	f
retrouvées	VER	f
retrouvés	VER	m
retrouves	VER	na
retrouveront	VER	na
retrouvais	VER	na
retrouverai	VER	na
retrouvait	VER	na
retrouvas	VER	na
retrouve	VER	na
retrouvent	VER	na
retrouver	VER	na
retrouvera	VER	na
retrouveraient	VER	na
retrouverons	VER	na
retrouverais	VER	na
retrouverait	VER	na
retrouveras	VER	na
retrouverez	VER	na
retrouvai	VER	na
retrouverions	VER	na
retrouveriez	VER	na
retrouvant	VER	na
ville	NOM	f
villes	NOM	f
terres	NOM	f
terre	NOM	f
gagnerons	VER	na
gagneront	VER	na
gagnes	VER	na
gagnez	VER	na
gagniez	VER	na
gagnions	VER	na
gagnons	VER	na
gagnerez	VER	na
gagnâmes	VER	na
gagnât	VER	na
gagnèrent	VER	na
gagné	VER	m
gagnée	VER	f
gagnées	VER	f
gagnés	VER	m
gagneriez	VER	na
gagnerions	VER	na
gagneras	VER	na
gagne	VER	na
gagna	VER	na
gagnai	VER	na
gagnerait	VER	na
gagnais	VER	na
gagnait	VER	na
gagnant	VER	na
gagnaient	VER	na
gagnent	VER	na
gagner	VER	na
gagnera	VER	na
gagnerai	VER	na
gagneraient	VER	na
gagnerais	VER	na
semaine	NOM	f
semaines	NOM	f
achetassent	VER	na
acheta	VER	na
achetai	VER	na
achetaient	VER	na
achetais	VER	na
achetait	VER	na
achetant	VER	na
achèterons	VER	na
acheter	VER	na
achetons	VER	na
achetât	VER	na
achetèrent	VER	na
acheté	VER	m
achetée	VER	f
achetées	VER	f
achetés	VER	m
achète	VER	na
achètent	VER	na
achètera	VER	na
achèterai	VER	na
achetions	VER	na
achèteraient	VER	na
achetâmes	VER	na
achèterais	VER	na
achètes	VER	na
achèteront	VER	na
achèterions	VER	na
achèteriez	VER	na
achèterez	VER	na
achèteras	VER	na
achetiez	VER	na
achetez	VER	na
achèterait	VER	na
longtemps	ADV	na
gars	NOM	m
chambres	NOM	f
chambre	NOM	f
hé	ONO	na
côtés	NOM	m
côté	NOM	m
leur	PRO:per	na
leur	PRO:pos	na
vieux	ADJ	m
vieilles	ADJ	f
vieille	ADJ	f
rappelant	VER	na
rappelait	VER	na
rappellerons	VER	na
rappelleriez	VER	na
rappelons	VER	na
rappelâmes	VER	na
rappelât	VER	na
rappellerez	VER	na
rappelleras	VER	na
rappelèrent	VER	na
rappellerais	VER	na
rappela	VER	na
rappelé	VER	m
rappelée	VER	f
rappelés	VER	m
rappellent	VER	na
rappellera	VER	na
rappellerai	VER	na
rappelleraient	VER	na
rappelle	VER	na
rappellerait	VER	na
rappelai	VER	na
rappeler	VER	na
rappelez	VER	na
rappeliez	VER	na
rappelleront	VER	na
rappelles	VER	na
rappelaient	VER	na
rappelions	VER	na
rappelais	VER	na
liront	VER	na
lise	VER	na
lisant	VER	na
lisait	VER	na
lisais	VER	na
lisaient	VER	na
lis	VER	na
lirons	VER	na
lises	VER	na
liriez	VER	na
lirez	VER	na
lisions	VER	na
lue	VER	f
lu	VER	m
lut	VER	na
lus	VER	m
lurent	VER	na
lit-divan	VER	na
lit	VER	na
lisiez	VER	na
lisent	VER	na
lire	VER	na
lisons	VER	na
lues	VER	f
liraient	VER	na
lisez	VER	na
lirai	VER	na
lirais	VER	na
liras	VER	na
lirait	VER	na
lût	VER	na
lûmes	VER	na
lira	VER	na
cas	NOM	m
mots	NOM	m
mot	NOM	m
seulement	ADV	na
voici	PRE	na
saluts	NOM	m
salut	NOM	m
montiez	VER	na
montions	VER	na
monterais	VER	na
monterait	VER	na
monteraient	VER	na
monteriez	VER	na
monterons	VER	na
montez	VER	na
montes	VER	na
monterez	VER	na
montant	VER	na
montât	VER	na
monteront	VER	na
montée	VER	f
monté	VER	m
monteras	VER	na
montées	VER	f
montais	VER	na
montaient	VER	na
montons	VER	na
montés	VER	m
montai	VER	na
montâmes	VER	na
monta	VER	na
montent	VER	na
monter	VER	na
montera	VER	na
montèrent	VER	na
monterai	VER	na
monte	VER	na
montait	VER	na
désolé	ADJ	m
désolée	ADJ	f
désolées	ADJ	f
désolés	ADJ	m
quitté	VER	m
quittés	VER	m
quittées	VER	f
quittée	VER	f
quittes	VER	na
quittèrent	VER	na
quitterons	VER	na
quitteriez	VER	na
quitterez	VER	na
quitteras	VER	na
quitterait	VER	na
quitterais	VER	na
quitteraient	VER	na
quitterai	VER	na
quittera	VER	na
quitter	VER	na
quittent	VER	na
quitte	VER	na
quittassent	VER	na
quittas	VER	na
quittant	VER	na
quittait	VER	na
quittaient	VER	na
quittai	VER	na
quitta	VER	na
quittât	VER	na
quitterions	VER	na
quittais	VER	na
quitteront	VER	na
quittâmes	VER	na
quittions	VER	na
quittiez	VER	na
quittez	VER	na
quittons	VER	na
police	NOM	f
polices	NOM	f
suites	NOM	f
suite	NOM	f
matins	NOM	m
matin	NOM	m
emmèneraient	VER	na
emmenés	VER	m
emmènerons	VER	na
emmènerais	VER	na
emmèneras	VER	na
emmèneront	VER	na
emmènerions	VER	na
emmèneriez	VER	na
emmènerez	VER	na
emmena	VER	na
emmène	VER	na
emmènent	VER	na
emmènerait	VER	na
emmènera	VER	na
emmené	VER	m
emmènes	VER	na
emmenèrent	VER	na
emmenons	VER	na
emmenions	VER	na
emmeniez	VER	na
emmenez	VER	na
emmenée	VER	f
emmener	VER	na
emmenât	VER	na
emmenant	VER	na
emmenées	VER	f
emmènerai	VER	na
emmenait	VER	na
emmenais	VER	na
emmenaient	VER	na
emmenai	VER	na
touchons	VER	na
toucheraient	VER	na
toucherais	VER	na
touchât	VER	na
touchiez	VER	na
touchions	VER	na
toucheront	VER	na
touchez	VER	na
touches	VER	na
toucherons	VER	na
toucha	VER	na
toucherions	VER	na
touchai	VER	na
touchaient	VER	na
touchais	VER	na
touchait	VER	na
touchant	VER	na
touche	VER	na
touchent	VER	na
toucher	VER	na
touchera	VER	na
toucherai	VER	na
toucherez	VER	na
touchées	VER	f
toucheras	VER	na
touché	VER	m
touchés	VER	m
toucherait	VER	na
touchèrent	VER	na
touchée	VER	f
continuez	VER	na
continues	VER	na
continuait	VER	na
continuais	VER	na
continuaient	VER	na
continuerez	VER	na
continuai	VER	na
continua	VER	na
continuant	VER	na
continueriez	VER	na
continuerons	VER	na
continuassent	VER	na
continue	VER	na
continueront	VER	na
continuiez	VER	na
continuions	VER	na
continuent	VER	na
continués	VER	m
continuons	VER	na
continuâmes	VER	na
continuera	VER	na
continuerai	VER	na
continueras	VER	na
continueraient	VER	na
continuât	VER	na
continuèrent	VER	na
continuer	VER	na
continué	VER	m
continuerait	VER	na
continuerais	VER	na
continuée	VER	f
continuées	VER	f
gros	ADJ	m
grosse	ADJ	f
grosses	ADJ	f
enfin	ADV	na
mari	NOM	m
maris	NOM	m
là-bas	ADV	na
revoir	NOM	m
importée	VER	f
importés	VER	m
important	VER	na
importait	VER	na
importaient	VER	na
importa	VER	na
importeraient	VER	na
importerait	VER	na
importes	VER	na
importât	VER	na
importé	VER	m
importées	VER	f
importe	VER	na
importera	VER	na
importer	VER	na
importent	VER	na
papa	NOM	m
puis	CON	na
train	NOM	m
trains	NOM	m
manqueront	VER	na
manquiez	VER	na
manquez	VER	na
manques	VER	na
manqueraient	VER	na
manquerait	VER	na
manquerais	VER	na
manqué	VER	m
manqueras	VER	na
manquerons	VER	na
manquerez	VER	na
manqueriez	VER	na
manquerions	VER	na
manqués	VER	m
manquions	VER	na
manque	VER	na
manqua	VER	na
manquai	VER	na
manquaient	VER	na
manquais	VER	na
manquait	VER	na
manquant	VER	na
manquassent	VER	na
manquent	VER	na
manquons	VER	na
manquer	VER	na
manquée	VER	f
manquées	VER	f
manquerai	VER	na
manquèrent	VER	na
manquât	VER	na
manquâmes	VER	na
manquera	VER	na
racontent	VER	na
raconta	VER	na
raconterez	VER	na
racontés	VER	m
racontées	VER	f
racontée	VER	f
raconté	VER	m
racontèrent	VER	na
racontât	VER	na
racontons	VER	na
racontions	VER	na
racontiez	VER	na
racontez	VER	na
racontes	VER	na
raconteront	VER	na
racontai	VER	na
raconterons	VER	na
raconteras	VER	na
raconte	VER	na
racontaient	VER	na
racontais	VER	na
racontait	VER	na
raconterait	VER	na
racontas	VER	na
racontant	VER	na
raconter	VER	na
racontera	VER	na
raconterai	VER	na
raconteraient	VER	na
raconterais	VER	na
ensemble	ADV	na
juste	ADV	na
mauvais	ADJ	m
mauvaise	ADJ	f
mauvaises	ADJ	f
film	NOM	m
films	NOM	m
répondîmes	VER	na
répondirent	VER	na
répondues	VER	f
répondu	VER	m
répondait	VER	na
réponds	VER	na
répondant	VER	na
réponde	VER	na
répondent	VER	na
répondes	VER	na
répondez	VER	na
répondiez	VER	na
répondront	VER	na
répondions	VER	na
répondis	VER	na
répondaient	VER	na
répondrons	VER	na
répondit	VER	na
répondons	VER	na
répondra	VER	na
répondrai	VER	na
répondraient	VER	na
répondrais	VER	na
répondrait	VER	na
répondras	VER	na
répondre	VER	na
répondrez	VER	na
répondais	VER	na
répond	VER	na
répondriez	VER	na
répondît	VER	na
garçon	NOM	m
garçons	NOM	m
peu	ADV	na
corps	NOM	m
celui	PRO:dem	m
autres	PRO:ind	na
heureuse	ADJ	f
heureux	ADJ	m
heureuses	ADJ	f
loin	ADV	na
sauveront	VER	na
sauverons	VER	na
sauvés	VER	m
sauverais	VER	na
sauverait	VER	na
sauvées	VER	f
sauvée	VER	f
sauvé	VER	m
sauvèrent	VER	na
sauvât	VER	na
sauvâmes	VER	na
sauvons	VER	na
sauvions	VER	na
sauve	VER	na
sauviez	VER	na
sauveras	VER	na
sauvez	VER	na
sauverai	VER	na
sauves	VER	na
sauverez	VER	na
sauvera	VER	na
sauveraient	VER	na
sauver	VER	na
sauvant	VER	na
sauvait	VER	na
sauvais	VER	na
sauvent	VER	na
sauva	VER	na
sauvaient	VER	na
sauvai	VER	na
chaque	ADJ:ind	na
retourneriez	VER	na
retourneras	VER	na
retournerez	VER	na
retournerons	VER	na
retourneront	VER	na
retournes	VER	na
retournez	VER	na
retourniez	VER	na
retournerait	VER	na
retourneraient	VER	na
retournerais	VER	na
retournons	VER	na
retournerai	VER	na
retournera	VER	na
retourner	VER	na
retournent	VER	na
retourne	VER	na
retournant	VER	na
retournait	VER	na
retournais	VER	na
retournaient	VER	na
retournai	VER	na
retourna	VER	na
retournions	VER	na
retournerions	VER	na
retournâmes	VER	na
retourné	VER	m
retournés	VER	m
retournées	VER	f
retournée	VER	f
retournât	VER	na
retournèrent	VER	na
leurs	ADJ:pos	na
rencontreras	VER	na
rencontrai	VER	na
rencontra	VER	na
rencontrez	VER	na
rencontreraient	VER	na
rencontrerais	VER	na
rencontrerait	VER	na
rencontrerez	VER	na
rencontrerons	VER	na
rencontres	VER	na
rencontreriez	VER	na
rencontraient	VER	na
rencontrées	VER	f
rencontrés	VER	m
rencontrerions	VER	na
rencontrerai	VER	na
rencontrais	VER	na
rencontrons	VER	na
rencontrent	VER	na
rencontrer	VER	na
rencontreront	VER	na
rencontrait	VER	na
rencontrèrent	VER	na
rencontrâmes	VER	na
rencontré	VER	m
rencontrions	VER	na
rencontriez	VER	na
rencontrera	VER	na
rencontrée	VER	f
rencontre	VER	na
rencontrasse	VER	na
rencontrant	VER	na
rencontrât	VER	na
coeur	NOM	m
coeurs	NOM	m
voler	VER	na
volent	VER	na
vole	VER	na
volassent	VER	na
volait	VER	na
volais	VER	na
voleraient	VER	na
volera	VER	na
volerai	VER	na
volés	VER	m
volées	VER	f
volée	VER	f
volé	VER	m
volèrent	VER	na
volât	VER	na
volons	VER	na
volions	VER	na
voliez	VER	na
volez	VER	na
voles	VER	na
voleront	VER	na
volerons	VER	na
voleriez	VER	na
volerez	VER	na
voleras	VER	na
volerait	VER	na
volerais	VER	na
volai	VER	na
volaient	VER	na
volant	VER	na
vola	VER	na
fermeront	VER	na
fermerais	VER	na
fermerait	VER	na
fermeras	VER	na
fermerez	VER	na
fermeriez	VER	na
fermés	VER	m
fermées	VER	f
fermions	VER	na
fermé	VER	m
fermèrent	VER	na
fermât	VER	na
fermons	VER	na
fermerons	VER	na
fermiez	VER	na
fermez	VER	na
fermée	VER	f
fermeraient	VER	na
fermerai	VER	na
fermait	VER	na
ferma	VER	na
fermai	VER	na
fermera	VER	na
fermais	VER	na
fermaient	VER	na
fermant	VER	na
ferme	VER	na
ferment	VER	na
fermer	VER	na
fermes	VER	na
car	CON	na
vaudras	VER	na
vaudrez	VER	na
vaudrions	VER	na
vaudrons	VER	na
vaudront	VER	na
vaut	VER	na
vaillent	VER	na
valions	VER	na
valu	VER	m
valaient	VER	na
valais	VER	na
valait	VER	na
valant	VER	na
valent	VER	na
valez	VER	na
vaux	VER	na
valiez	VER	na
vaudrait	VER	na
valoir	VER	na
valons	VER	na
value	VER	f
values	VER	f
valurent	VER	na
valut	VER	na
valût	VER	na
vaudra	VER	na
vaudrai	VER	na
vaudraient	VER	na
vaille	VER	na
vaudrais	VER	na
descendus	VER	m
descendue	VER	f
descendues	VER	f
descends	VER	na
descendîmes	VER	na
descendît	VER	na
descendu	VER	m
descendent	VER	na
descendra	VER	na
descend	VER	na
descendit	VER	na
descendis	VER	na
descendaient	VER	na
descendirent	VER	na
descendant	VER	na
descendions	VER	na
descendais	VER	na
descendons	VER	na
descendras	VER	na
descendiez	VER	na
descendes	VER	na
descendait	VER	na
descendez	VER	na
descende	VER	na
descendrait	VER	na
descendrais	VER	na
descendraient	VER	na
descendre	VER	na
descendrez	VER	na
descendriez	VER	na
descendrions	VER	na
descendrai	VER	na
descendrons	VER	na
descendront	VER	na
ok	ADJ	na
feu	NOM	m
feux	NOM	m
doctoresse	NOM	f
docteur	NOM	m
docteurs	NOM	m
suffiraient	VER	na
suffira	VER	na
suffire	VER	na
suffirait	VER	na
suffirais	VER	na
suffise	VER	na
suffît	VER	na
suffirent	VER	na
suffit	VER	na
suffi	VER	m
suffiront	VER	na
suffis	VER	na
suffisons	VER	na
suffisez	VER	na
suffisaient	VER	na
suffisais	VER	na
suffisait	VER	na
suffisant	VER	na
suffisent	VER	na
suffisions	VER	na
suffirai	VER	na
façons	NOM	f
façon	NOM	f
nouveaux	NOM	m
nouvelles	NOM	f
nouvelle	NOM	f
nouveau	NOM	m
importante	ADJ	f
important	ADJ	m
importantes	ADJ	f
importants	ADJ	m
semblaient	VER	na
semblais	VER	na
semble	VER	na
sembla	VER	na
semblé	VER	m
semblent	VER	na
semblait	VER	na
semblèrent	VER	na
semblât	VER	na
semblons	VER	na
semblions	VER	na
sembliez	VER	na
semblez	VER	na
sembles	VER	na
sembleront	VER	na
semblant	VER	na
semblerait	VER	na
sembleraient	VER	na
semblera	VER	na
sembler	VER	na
comptée	VER	f
compta	VER	na
comptés	VER	m
comptées	VER	f
compté	VER	m
comptèrent	VER	na
comptaient	VER	na
comptais	VER	na
comptait	VER	na
comptant	VER	na
compte	VER	na
comptent	VER	na
compter	VER	na
comptera	VER	na
compterai	VER	na
compteraient	VER	na
compterais	VER	na
compterait	VER	na
compteras	VER	na
compterez	VER	na
compterons	VER	na
compteront	VER	na
comptes	VER	na
comptez	VER	na
comptiez	VER	na
comptions	VER	na
comptât	VER	na
comptons	VER	na
comptai	VER	na
vers	PRE	na
joli	ADJ	m
jolie	ADJ	f
jolis	ADJ	m
jolies	ADJ	f
point	NOM	m
points	NOM	m
avant	ADV	na
hier	ADV	na
chienne	NOM	f
chiens	NOM	m
chiennes	NOM	f
chien	NOM	m
dont	PRO:rel	na
dont	PRO:int	na
petites	NOM	f
petits	NOM	m
petite	NOM	f
petit	NOM	m
guerres	NOM	f
guerre	NOM	f
genres	NOM	m
genre	NOM	m
merde	ONO	na
meilleur	ADJ	m
meilleure	ADJ	f
meilleures	ADJ	f
meilleurs	ADJ	m
marie	VER	na
mariés	VER	m
marièrent	VER	na
marié	VER	m
mariée	VER	f
mariées	VER	f
mariât	VER	na
mariassent	VER	na
marias	VER	na
mariant	VER	na
mariait	VER	na
marient	VER	na
marierai	VER	na
marier	VER	na
mariera	VER	na
marierez	VER	na
mariais	VER	na
marieras	VER	na
marierait	VER	na
marierais	VER	na
mariaient	VER	na
mariai	VER	na
maria	VER	na
marierions	VER	na
marierons	VER	na
marieront	VER	na
maries	VER	na
mariez	VER	na
marieraient	VER	na
marions	VER	na
mariions	VER	na
marieriez	VER	na
armes	NOM	f
arme	NOM	f
cause	NOM	f
causes	NOM	f
endroits	NOM	m
endroit	NOM	m
ordres	NOM	m
ordre	NOM	m
poseraient	VER	na
poseront	VER	na
poserons	VER	na
poserions	VER	na
poseriez	VER	na
poserez	VER	na
poserait	VER	na
poserais	VER	na
posera	VER	na
poserai	VER	na
posez	VER	na
poser	VER	na
posent	VER	na
pose	VER	na
posas	VER	na
posant	VER	na
posait	VER	na
posais	VER	na
posaient	VER	na
posai	VER	na
posa	VER	na
poses	VER	na
posés	VER	m
posiez	VER	na
posâmes	VER	na
posions	VER	na
posées	VER	f
posée	VER	f
posé	VER	m
posèrent	VER	na
posât	VER	na
poseras	VER	na
posons	VER	na
restes	NOM	m
reste	NOM	m
pieds	NOM	m
pied	NOM	m
envie	NOM	f
envies	NOM	f
fin	NOM	na
fins	NOM	na
merde	NOM	f
merdes	NOM	f
tiens	ONO	na
inquiétèrent	VER	na
inquiétassent	VER	na
inquiétât	VER	na
inquiétait	VER	na
inquiétais	VER	na
inquiétaient	VER	na
inquiété	VER	m
inquiéter	VER	na
inquiètent	VER	na
inquiétai	VER	na
inquiétons	VER	na
inquiétant	VER	na
inquiétera	VER	na
inquiétée	VER	f
inquiéteriez	VER	na
inquiète	VER	na
inquiéterais	VER	na
inquiéterait	VER	na
inquiètes	VER	na
inquiétées	VER	f
inquiéta	VER	na
inquiétions	VER	na
inquiéteras	VER	na
inquiéteront	VER	na
inquiéteraient	VER	na
inquiéterai	VER	na
inquiétez	VER	na
inquiétiez	VER	na
inquiétés	VER	m
bougèrent	VER	na
bougé	VER	m
bougée	VER	f
bougées	VER	f
bougeant	VER	na
bougent	VER	na
bougeons	VER	na
bougerait	VER	na
bougerais	VER	na
bougeraient	VER	na
bougerai	VER	na
bougera	VER	na
bouger	VER	na
bougeassent	VER	na
bougeriez	VER	na
bougeait	VER	na
bougeais	VER	na
bougeaient	VER	na
bougeai	VER	na
bougea	VER	na
bouge	VER	na
bougerez	VER	na
bougeras	VER	na
bougerons	VER	na
bougeront	VER	na
bouges	VER	na
bougez	VER	na
bougeât	VER	na
bougions	VER	na
plutôt	ADV	na
une	PRO:ind	f
apporterez	VER	na
apportât	VER	na
apportez	VER	na
apportiez	VER	na
apporterons	VER	na
apporteriez	VER	na
apporterait	VER	na
apporteras	VER	na
apportons	VER	na
apporté	VER	m
apporterais	VER	na
apportions	VER	na
apportèrent	VER	na
apporte	VER	na
apportée	VER	f
apportées	VER	f
apportés	VER	m
apporteraient	VER	na
apportas	VER	na
apporterai	VER	na
apporteront	VER	na
apporta	VER	na
apportai	VER	na
apportaient	VER	na
apportent	VER	na
apportais	VER	na
apportait	VER	na
apportant	VER	na
apportes	VER	na
apporter	VER	na
apportera	VER	na
nouveaux	ADJ	m
nouveau	ADJ	m
pardon	ONO	na
photo	NOM	f
photos	NOM	f
plein	ADJ	m
pleine	ADJ	f
pleines	ADJ	f
pleins	ADJ	m
devant	PRE	na
décideraient	VER	na
déciderez	VER	na
décideras	VER	na
déciderait	VER	na
déciderais	VER	na
décida	VER	na
déciderai	VER	na
décidera	VER	na
décider	VER	na
décide	VER	na
décidant	VER	na
décidait	VER	na
décident	VER	na
déciderons	VER	na
déciderions	VER	na
décidaient	VER	na
décideront	VER	na
décides	VER	na
décidez	VER	na
décidiez	VER	na
décidions	VER	na
décidons	VER	na
décidâmes	VER	na
décidât	VER	na
décidèrent	VER	na
décidé	VER	m
décidée	VER	f
décidées	VER	f
décidés	VER	m
décidais	VER	na
décideriez	VER	na
décidai	VER	na
ainsi	ADV	na
droit	NOM	m
droits	NOM	m
aucune	ADJ:ind	f
vendiez	VER	na
vendit	VER	na
vendisse	VER	na
vendis	VER	na
vendirent	VER	na
vendions	VER	na
vendez	VER	na
vendra	VER	na
vendes	VER	na
vendent	VER	na
vende	VER	na
vendant	VER	na
vendait	VER	na
vendaient	VER	na
vendons	VER	na
vendraient	VER	na
vendrai	VER	na
vendrais	VER	na
vendrait	VER	na
vendras	VER	na
vendre	VER	na
vendrez	VER	na
vendriez	VER	na
vendrons	VER	na
vendront	VER	na
vends	VER	na
vendu	VER	m
vendue	VER	f
vendues	VER	f
vendus	VER	m
vendît	VER	na
vend	VER	na
vendais	VER	na
école	NOM	f
écoles	NOM	f
chers	ADJ	m
cher	ADJ	m
chère	ADJ	f
chères	ADJ	f
chef	NOM	na
chefs	NOM	na
tournai	VER	na
tournés	VER	m
tournées	VER	f
tournée	VER	f
tourné	VER	m
tournèrent	VER	na
tournât	VER	na
tournâmes	VER	na
tournez	VER	na
tourneront	VER	na
tournons	VER	na
tournions	VER	na
tournes	VER	na
tourneriez	VER	na
tournerions	VER	na
tournerons	VER	na
tournerez	VER	na
tourna	VER	na
tourneraient	VER	na
tournais	VER	na
tournas	VER	na
tournant	VER	na
tournerai	VER	na
tournait	VER	na
tourne	VER	na
tourner	VER	na
tournera	VER	na
tournerait	VER	na
tournerais	VER	na
tournaient	VER	na
tourneras	VER	na
tournent	VER	na
cachant	VER	na
cacherait	VER	na
cachait	VER	na
cache	VER	na
cachent	VER	na
cacher	VER	na
cachera	VER	na
cachais	VER	na
cachai	VER	na
cacherai	VER	na
cacha	VER	na
cacheraient	VER	na
cacherais	VER	na
cachions	VER	na
cacheras	VER	na
cacherez	VER	na
cacheriez	VER	na
cacheront	VER	na
caches	VER	na
cachez	VER	na
cachiez	VER	na
cachons	VER	na
cachés	VER	m
cachées	VER	f
cachât	VER	na
cachée	VER	f
cachèrent	VER	na
caché	VER	m
cacherons	VER	na
cachaient	VER	na
salut	ONO	na
boulots	NOM	m
boulot	NOM	m
pays	NOM	m
ceux	PRO:dem	m
possible	ADJ	na
possibles	ADJ	na
expliquant	VER	na
expliquons	VER	na
expliquer	VER	na
expliquera	VER	na
expliquerai	VER	na
emmener	VER	na
expliqueraient	VER	na
expliqueront	VER	na
expliquions	VER	na
expliquerais	VER	na
explique	VER	na
expliquerait	VER	na
expliqueras	VER	na
expliquées	VER	f
expliquée	VER	f
expliquerons	VER	na
expliquerez	VER	na
expliquent	VER	na
expliqué	VER	m
expliquiez	VER	na
expliqua	VER	na
expliquez	VER	na
expliquâmes	VER	na
expliquât	VER	na
expliques	VER	na
expliquait	VER	na
expliqués	VER	m
expliquai	VER	na
expliquaient	VER	na
expliquais	VER	na
expliqueriez	VER	na
expliquèrent	VER	na
battis	VER	na
battirent	VER	na
battions	VER	na
battiez	VER	na
battez	VER	na
battras	VER	na
battit	VER	na
battons	VER	na
battre	VER	na
battrait	VER	na
battrais	VER	na
battraient	VER	na
battrez	VER	na
battît	VER	na
battes	VER	na
battîmes	VER	na
battus	VER	m
battues	VER	f
battue	VER	f
battu	VER	m
battront	VER	na
battrons	VER	na
battrai	VER	na
battra	VER	na
battrions	VER	na
battent	VER	na
battais	VER	na
batte	VER	na
battriez	VER	na
bats	VER	na
bat	VER	na
battaient	VER	na
battait	VER	na
battant	VER	na
peines	NOM	f
peine	NOM	f
livres	NOM	na
livre	NOM	na
agissais	VER	na
agisse	VER	na
agît	VER	na
agissait	VER	na
agissant	VER	na
agissions	VER	na
agissent	VER	na
agisses	VER	na
agissez	VER	na
agissiez	VER	na
agissons	VER	na
agit	VER	na
agissaient	VER	na
agiriez	VER	na
agis	VER	m
agiront	VER	na
agirons	VER	na
agirez	VER	na
agirent	VER	na
agiras	VER	na
agirait	VER	na
agirais	VER	na
agiraient	VER	na
agirai	VER	na
agira	VER	na
agir	VER	na
agie	VER	f
agi	VER	m
imagineriez	VER	na
imagineras	VER	na
imaginions	VER	na
imaginant	VER	na
imaginiez	VER	na
imagina	VER	na
imaginai	VER	na
imaginaient	VER	na
imagineront	VER	na
imaginais	VER	na
imaginait	VER	na
imagine	VER	na
imaginent	VER	na
imaginer	VER	na
imaginerai	VER	na
imaginées	VER	f
imaginés	VER	m
imagineraient	VER	na
imaginerais	VER	na
imaginerait	VER	na
imaginez	VER	na
imagines	VER	na
imaginons	VER	na
imaginât	VER	na
imaginèrent	VER	na
imaginé	VER	m
imaginerons	VER	na
imaginée	VER	f
imaginâmes	VER	na
imaginerez	VER	na
tours	NOM	na
tour	NOM	na
après	ADV	na
adorant	VER	na
adorèrent	VER	na
adore	VER	na
adores	VER	na
adorons	VER	na
adoraient	VER	na
adorait	VER	na
adorais	VER	na
adoré	VER	m
adorai	VER	na
adora	VER	na
adorions	VER	na
adorent	VER	na
adorerai	VER	na
adorer	VER	na
adorée	VER	f
adorées	VER	f
adorera	VER	na
adoreraient	VER	na
adorerais	VER	na
adorerait	VER	na
adoreras	VER	na
adorerez	VER	na
adoreriez	VER	na
adoriez	VER	na
adorerions	VER	na
adorerons	VER	na
adoreront	VER	na
adorez	VER	na
adorés	VER	m
vérité	NOM	f
vérités	NOM	f
recevoir	VER	na
reçois	VER	na
recevaient	VER	na
recevais	VER	na
recevait	VER	na
recevant	VER	na
reçût	VER	na
recevez	VER	na
receviez	VER	na
recevions	VER	na
reçûmes	VER	na
reçoive	VER	na
reçut	VER	na
recevons	VER	na
reçus	VER	m
recevra	VER	na
recevrai	VER	na
recevras	VER	na
recevraient	VER	na
recevrais	VER	na
reçurent	VER	na
reçoit	VER	na
reçoivent	VER	na
recevrait	VER	na
recevront	VER	na
reçu	VER	m
reçue	VER	f
reçues	VER	f
reçoives	VER	na
recevrez	VER	na
recevriez	VER	na
recevrions	VER	na
recevrons	VER	na
gentils	ADJ	m
gentil	ADJ	m
gentille	ADJ	f
gentilles	ADJ	f
jetterais	VER	na
jetteraient	VER	na
jetterions	VER	na
jetèrent	VER	na
jetât	VER	na
jetâmes	VER	na
jettes	VER	na
jetteront	VER	na
jetterai	VER	na
jettera	VER	na
jettent	VER	na
jetterons	VER	na
jeté	VER	m
jetiez	VER	na
jetez	VER	na
jeter	VER	na
jetons	VER	na
jette	VER	na
jetteriez	VER	na
jetterez	VER	na
jetée	VER	f
jetas	VER	na
jetant	VER	na
jetait	VER	na
jetais	VER	na
jetaient	VER	na
jetai	VER	na
jeta	VER	na
jetés	VER	m
jetteras	VER	na
jetées	VER	f
jetterait	VER	na
jetions	VER	na
pleurerais	VER	na
pleureraient	VER	na
pleurerai	VER	na
pleurera	VER	na
pleurer	VER	na
pleurent	VER	na
pleurerait	VER	na
pleureront	VER	na
pleureras	VER	na
pleurerez	VER	na
pleurerons	VER	na
pleurant	VER	na
pleures	VER	na
pleurez	VER	na
pleuriez	VER	na
pleurions	VER	na
pleurons	VER	na
pleurât	VER	na
pleurèrent	VER	na
pleuré	VER	m
pleurée	VER	f
pleurées	VER	f
pleurés	VER	m
pleure	VER	na
pleurais	VER	na
pleurait	VER	na
pleurai	VER	na
pleura	VER	na
pleuraient	VER	na
bébé	NOM	m
bébés	NOM	m
parties	NOM	f
partie	NOM	f
nouvelles	ADJ	f
nouvelle	ADJ	f
jeux	NOM	m
jeu	NOM	m
amenons	VER	na
amenions	VER	na
amenez	VER	na
amener	VER	na
amenant	VER	na
amène	VER	na
amenait	VER	na
amenais	VER	na
amenaient	VER	na
amenai	VER	na
amena	VER	na
ameniez	VER	na
amènent	VER	na
amènerai	VER	na
amèneront	VER	na
amènerions	VER	na
amenèrent	VER	na
amèneriez	VER	na
amènerez	VER	na
amèneras	VER	na
amènerait	VER	na
amènerais	VER	na
amènes	VER	na
amenés	VER	m
amèneraient	VER	na
amènerons	VER	na
amènera	VER	na
amenées	VER	f
amenée	VER	f
amené	VER	m
amenât	VER	na
instants	NOM	m
instant	NOM	m
parents	NOM	m
parentes	NOM	f
parente	NOM	f
parent	NOM	m
durs	ADJ	m
dure	ADJ	f
dures	ADJ	f
dur	ADJ	m
service	NOM	m
services	NOM	m
plaisir	NOM	m
plaisirs	NOM	m
promettront	VER	na
promets	VER	na
promette	VER	na
promettaient	VER	na
promît	VER	na
promettais	VER	na
promettait	VER	na
promit	VER	na
promettant	VER	na
promîmes	VER	na
promises	VER	f
promettriez	VER	na
promet	VER	na
promettraient	VER	na
promettra	VER	na
promettons	VER	na
promirent	VER	na
promettrais	VER	na
promettrait	VER	na
promettras	VER	na
promettre	VER	na
promettiez	VER	na
promettez	VER	na
promettes	VER	na
promettent	VER	na
promis	VER	m
promise	VER	f
promettrai	VER	na
mentait	VER	na
mentais	VER	na
mentaient	VER	na
ment	VER	na
mens	VER	na
mentis	VER	na
mentions	VER	na
mentirez	VER	na
mentiront	VER	na
mentir	VER	na
mentirons	VER	na
mentiriez	VER	na
mentira	VER	na
mentirai	VER	na
mentiraient	VER	na
mentirais	VER	na
mentirait	VER	na
mentiras	VER	na
mentissent	VER	na
mentons	VER	na
mente	VER	na
mentiez	VER	na
mentant	VER	na
mentent	VER	na
mentez	VER	na
mentît	VER	na
menti	VER	m
mentes	VER	na
mentit	VER	na
soeurs	NOM	f
soeur	NOM	f
bientôt	ADV	na
lits	NOM	m
lit	NOM	m
tellement	ADV	na
utiliserons	VER	na
utiliserait	VER	na
utiliseras	VER	na
utiliserais	VER	na
utiliseraient	VER	na
utiliserions	VER	na
utilisés	VER	m
utilisèrent	VER	na
utiliseront	VER	na
utilisées	VER	f
utilisât	VER	na
utilisez	VER	na
utilisons	VER	na
utilisions	VER	na
utilises	VER	na
utilisiez	VER	na
utilisant	VER	na
utilisera	VER	na
utiliserai	VER	na
utiliserez	VER	na
utilisé	VER	m
utilisée	VER	f
utiliseriez	VER	na
utilisent	VER	na
utilisa	VER	na
utilise	VER	na
utilisai	VER	na
utilisaient	VER	na
utilisais	VER	na
utiliser	VER	na
utilisait	VER	na
lieu	NOM	m
lieux	NOM	m
lieus	NOM	m
coucherait	VER	na
coucherai	VER	na
couchées	VER	f
couché	VER	m
couchèrent	VER	na
couchent	VER	na
couchés	VER	m
couchée	VER	f
coucheraient	VER	na
coucherais	VER	na
couchât	VER	na
coucheriez	VER	na
couchez	VER	na
couchais	VER	na
couchant	VER	na
couche	VER	na
couchaient	VER	na
couchai	VER	na
coucherez	VER	na
coucher	VER	na
coucha	VER	na
coucherons	VER	na
coucheront	VER	na
couches	VER	na
couchiez	VER	na
coucherions	VER	na
couchions	VER	na
couchons	VER	na
couchera	VER	na
coucheras	VER	na
couchâmes	VER	na
couchait	VER	na
presque	ADV	na
dehors	ADV	na
préférais	VER	na
préféreriez	VER	na
préférerions	VER	na
préférerez	VER	na
préférait	VER	na
préférant	VER	na
préférai	VER	na
préférer	VER	na
préféreras	VER	na
préférera	VER	na
préférerait	VER	na
préférerais	VER	na
préféreraient	VER	na
préféraient	VER	na
préférerai	VER	na
préfère	VER	na
préfériez	VER	na
préféré	VER	m
préféra	VER	na
préférât	VER	na
préférâmes	VER	na
préférons	VER	na
préférions	VER	na
préférez	VER	na
préfèrent	VER	na
préféreront	VER	na
préférée	VER	f
préférées	VER	f
préfères	VER	na
préférés	VER	m
préférèrent	VER	na
content	ADJ	m
contentes	ADJ	f
contents	ADJ	m
contente	ADJ	f
pauvres	ADJ	na
pauvre	ADJ	na
offrit	VER	na
offrirons	VER	na
offrirez	VER	na
offrons	VER	na
offrirent	VER	na
offririez	VER	na
offrît	VER	na
offrions	VER	na
offriras	VER	na
offres	VER	na
offert	VER	m
offerte	VER	f
offertes	VER	f
offerts	VER	m
offrirait	VER	na
offrais	VER	na
offrait	VER	na
offrant	VER	na
offre	VER	na
offrent	VER	na
offraient	VER	na
offrez	VER	na
offrirai	VER	na
offriez	VER	na
offrirais	VER	na
offriraient	VER	na
offriront	VER	na
offrira	VER	na
offrir	VER	na
offris	VER	na
rois	NOM	m
roi	NOM	m
verres	NOM	m
verre	NOM	m
réveillerais	VER	na
réveillées	VER	f
réveillée	VER	f
réveilleras	VER	na
réveillerait	VER	na
réveiller	VER	na
réveilleraient	VER	na
réveillerai	VER	na
réveille	VER	na
réveillera	VER	na
réveillent	VER	na
réveillerez	VER	na
réveillant	VER	na
réveillé	VER	m
réveilleriez	VER	na
réveillerons	VER	na
réveilleront	VER	na
réveilles	VER	na
réveillez	VER	na
réveilliez	VER	na
réveillions	VER	na
réveillons	VER	na
réveillâmes	VER	na
réveilla	VER	na
réveillai	VER	na
réveillaient	VER	na
réveillais	VER	na
réveillait	VER	na
réveillât	VER	na
réveillèrent	VER	na
réveillés	VER	m
aucun	ADJ:ind	m
aides	NOM	na
aide	NOM	na
d'abord	ADV	na
journée	NOM	f
journées	NOM	f
prépara	VER	na
préparés	VER	m
préparées	VER	f
préparée	VER	f
préparé	VER	m
préparèrent	VER	na
préparât	VER	na
préparons	VER	na
préparions	VER	na
prépariez	VER	na
prépares	VER	na
prépareront	VER	na
préparerons	VER	na
préparerez	VER	na
prépareras	VER	na
préparerait	VER	na
préparai	VER	na
préparaient	VER	na
préparais	VER	na
préparait	VER	na
préparant	VER	na
prépare	VER	na
préparent	VER	na
préparer	VER	na
préparera	VER	na
préparerai	VER	na
prépareraient	VER	na
préparerais	VER	na
préparez	VER	na
numéro	NOM	m
numéros	NOM	m
permettaient	VER	na
permettrions	VER	na
permettrais	VER	na
permettes	VER	na
permettez	VER	na
permettiez	VER	na
permettions	VER	na
permettons	VER	na
permettra	VER	na
permettrai	VER	na
permettraient	VER	na
permettrait	VER	na
permise	VER	f
permettras	VER	na
permettre	VER	na
permettrez	VER	na
permettriez	VER	na
permises	VER	f
permettrons	VER	na
permettront	VER	na
permirent	VER	na
permissent	VER	na
permettent	VER	na
permette	VER	na
permettant	VER	na
permet	VER	na
permettais	VER	na
permettait	VER	na
permis	VER	m
permit	VER	na
permets	VER	na
permît	VER	na
en	ADV	na
ramena	VER	na
ramenâmes	VER	na
ramenaient	VER	na
ramenais	VER	na
ramenons	VER	na
ramenât	VER	na
ramenait	VER	na
ramenant	VER	na
ramener	VER	na
ramenez	VER	na
rameniez	VER	na
ramenions	VER	na
ramenai	VER	na
ramenèrent	VER	na
ramenée	VER	f
ramenées	VER	f
ramèneraient	VER	na
ramènerai	VER	na
ramènes	VER	na
ramènera	VER	na
ramènent	VER	na
ramène	VER	na
ramenés	VER	m
ramènerait	VER	na
ramènerais	VER	na
ramené	VER	m
ramèneras	VER	na
ramènerez	VER	na
ramèneriez	VER	na
ramènerions	VER	na
ramènerons	VER	na
ramèneront	VER	na
enlève	VER	na
enlevés	VER	m
enlevée	VER	f
enlèveraient	VER	na
enlèvent	VER	na
enlèvera	VER	na
enlèverai	VER	na
enlèverais	VER	na
enlèverait	VER	na
enlèveras	VER	na
enlèverez	VER	na
enlèveriez	VER	na
enlèverons	VER	na
enlèveront	VER	na
enlèves	VER	na
enlevées	VER	f
enlevèrent	VER	na
enlevé	VER	m
enlevaient	VER	na
enlevât	VER	na
enlevons	VER	na
enlevions	VER	na
enleviez	VER	na
enlevez	VER	na
enlever	VER	na
enlevant	VER	na
enleva	VER	na
enlevai	VER	na
enlevait	VER	na
enlevais	VER	na
chéris	NOM	m
chéries	NOM	f
chérie	NOM	f
chéri	NOM	na
fort	ADV	na
lâchées	VER	f
lâchent	VER	na
lâchera	VER	na
lâcherai	VER	na
lâchaient	VER	na
lâcheraient	VER	na
lâcherais	VER	na
lâcherait	VER	na
lâchais	VER	na
lâchai	VER	na
lâchés	VER	m
lâcheras	VER	na
lâcha	VER	na
lâcherez	VER	na
lâcheriez	VER	na
lâcher	VER	na
lâchons	VER	na
lâcheront	VER	na
lâches	VER	na
lâchez	VER	na
lâche	VER	na
lâchiez	VER	na
lâchant	VER	na
lâchions	VER	na
lâcherons	VER	na
lâchât	VER	na
lâchèrent	VER	na
lâché	VER	m
lâchait	VER	na
lâchée	VER	f
choisie	VER	f
choisir	VER	na
choisi	VER	m
choisies	VER	f
choisissant	VER	na
choisira	VER	na
choisissions	VER	na
choisissais	VER	na
choisissaient	VER	na
choisis	VER	m
choisiront	VER	na
choisirons	VER	na
choisirions	VER	na
choisiriez	VER	na
choisirez	VER	na
choisirent	VER	na
choisiras	VER	na
choisissons	VER	na
choisirai	VER	na
choisîmes	VER	na
choisisse	VER	na
choisît	VER	na
choisissiez	VER	na
choisissent	VER	na
choisissez	VER	na
choisisses	VER	na
choisissait	VER	na
choisirais	VER	na
choisiraient	VER	na
choisirait	VER	na
choisit	VER	na
musiques	NOM	f
musique	NOM	f
conduire	VER	na
conduirais	VER	na
conduirait	VER	na
conduiras	VER	na
conduirez	VER	na
conduiriez	VER	na
conduirons	VER	na
conduiront	VER	na
conduis	VER	na
conduisaient	VER	na
conduisais	VER	na
conduits	VER	m
conduites	VER	f
conduisait	VER	na
conduisant	VER	na
conduirai	VER	na
conduise	VER	na
conduisent	VER	na
conduira	VER	na
conduises	VER	na
conduisez	VER	na
conduisiez	VER	na
conduisions	VER	na
conduisirent	VER	na
conduisis	VER	na
conduisit	VER	na
conduisons	VER	na
conduisît	VER	na
conduit	VER	m
conduite	VER	f
conduiraient	VER	na
faute	NOM	f
fautes	NOM	f
calmons	VER	na
calmé	VER	m
calmeraient	VER	na
calmerais	VER	na
calmeras	VER	na
calmerez	VER	na
calmerons	VER	na
calmeront	VER	na
calmes	VER	na
calmez	VER	na
calmiez	VER	na
calmais	VER	na
calmés	VER	m
calmées	VER	f
calmée	VER	f
calmât	VER	na
calmerai	VER	na
calmerait	VER	na
calmèrent	VER	na
calment	VER	na
calma	VER	na
calmera	VER	na
calmait	VER	na
calmai	VER	na
calmaient	VER	na
calmant	VER	na
calmas	VER	na
calmer	VER	na
calme	VER	na
mariages	NOM	m
mariage	NOM	m
comment	ONO	na
bureaux	NOM	m
bureau	NOM	m
route	NOM	f
routes	NOM	f
chanta	VER	na
chantais	VER	na
chantaient	VER	na
chantés	VER	m
chantées	VER	f
chantai	VER	na
chantée	VER	f
chantèrent	VER	na
chanté	VER	m
chante	VER	na
chanteras	VER	na
chantât	VER	na
chantent	VER	na
chanterait	VER	na
chanterez	VER	na
chanterais	VER	na
chanteriez	VER	na
chantant	VER	na
chanterons	VER	na
chanteront	VER	na
chantes	VER	na
chantez	VER	na
chantait	VER	na
chanteraient	VER	na
chanterai	VER	na
chantera	VER	na
chanter	VER	na
chantiez	VER	na
chantions	VER	na
chantons	VER	na
chantâmes	VER	na
disparaissaient	VER	na
disparais	VER	na
disparaissons	VER	na
disparaisses	VER	na
disparaissait	VER	na
disparaissez	VER	na
disparûmes	VER	na
disparaissent	VER	na
disparut	VER	na
disparus	VER	m
disparaisse	VER	na
disparurent	VER	na
disparues	VER	f
disparue	VER	f
disparu	VER	m
disparaîtront	VER	na
disparaîtrons	VER	na
disparaîtrions	VER	na
disparaître	VER	na
disparaîtras	VER	na
disparaîtrez	VER	na
disparaissiez	VER	na
disparaîtra	VER	na
disparaissais	VER	na
disparaissant	VER	na
disparaîtrait	VER	na
disparaît	VER	na
disparaissions	VER	na
disparût	VER	na
disparaîtrai	VER	na
disparaîtraient	VER	na
disparaîtrais	VER	na
levât	VER	na
levâmes	VER	na
levions	VER	na
leviez	VER	na
levez	VER	na
levés	VER	m
levées	VER	f
levée	VER	f
levèrent	VER	na
levé	VER	m
levons	VER	na
lever	VER	na
lèves	VER	na
lèverons	VER	na
lèverez	VER	na
lèveras	VER	na
lèverait	VER	na
lèverais	VER	na
lèveraient	VER	na
lèverai	VER	na
lèvent	VER	na
lève	VER	na
leva	VER	na
levai	VER	na
levaient	VER	na
levais	VER	na
levait	VER	na
levant	VER	na
lèveront	VER	na
lèvera	VER	na
présentèrent	VER	na
présentât	VER	na
présenterais	VER	na
présenterait	VER	na
présenteras	VER	na
présenterez	VER	na
présenteriez	VER	na
présenterons	VER	na
présenteront	VER	na
présentes	VER	na
présentez	VER	na
présentiez	VER	na
présentions	VER	na
présentés	VER	m
présentées	VER	f
présentée	VER	f
présenté	VER	m
présenteraient	VER	na
présenterai	VER	na
présentera	VER	na
présentait	VER	na
présenta	VER	na
présentai	VER	na
présenter	VER	na
présentais	VER	na
présentaient	VER	na
présentant	VER	na
présentassent	VER	na
présente	VER	na
présentent	VER	na
présentons	VER	na
acceptées	VER	f
accepteriez	VER	na
accepterait	VER	na
accepterez	VER	na
acceptés	VER	m
accepteras	VER	na
acceptera	VER	na
acceptez	VER	na
acceptent	VER	na
accepter	VER	na
accepte	VER	na
acceptes	VER	na
accepteront	VER	na
acceptasses	VER	na
acceptassent	VER	na
accepterons	VER	na
accepterions	VER	na
acceptant	VER	na
acceptait	VER	na
acceptais	VER	na
acceptaient	VER	na
acceptai	VER	na
acceptée	VER	f
accepta	VER	na
accepteraient	VER	na
acceptiez	VER	na
acceptions	VER	na
accepterais	VER	na
acceptons	VER	na
accepté	VER	m
accepterai	VER	na
acceptèrent	VER	na
acceptâmes	VER	na
acceptât	VER	na
sinon	CON	na
longues	ADJ	f
longue	ADJ	f
longs	ADJ	m
long	ADJ	m
café	NOM	m
cafés	NOM	m
propre	ADJ	na
propres	ADJ	na
confiance	NOM	f
confiances	NOM	f
revus	VER	m
revoyons	VER	na
reverrais	VER	na
revîmes	VER	na
reverrait	VER	na
revues	VER	f
revue	VER	f
revu	VER	m
revoyions	VER	na
reverrai	VER	na
revoyiez	VER	na
revoyez	VER	na
revoyant	VER	na
revoyait	VER	na
revoyais	VER	na
revoyaient	VER	na
reverrez	VER	na
reverraient	VER	na
reverra	VER	na
revoies	VER	na
reverront	VER	na
revirent	VER	na
revit	VER	na
revoie	VER	na
reverrons	VER	na
revoit	VER	na
revoient	VER	na
revoir	VER	na
reverrions	VER	na
revois	VER	na
reverras	VER	na
cinq	ADJ:num	na
bonsoirs	NOM	m
bonsoir	NOM	m
comptes	NOM	m
compte	NOM	m
téléphones	NOM	m
téléphone	NOM	m
cassez	VER	na
cassant	VER	na
casse	VER	na
casserez	VER	na
casseras	VER	na
casserait	VER	na
cassèrent	VER	na
casserais	VER	na
casseraient	VER	na
cassent	VER	na
casser	VER	na
casserai	VER	na
cassait	VER	na
cassaient	VER	na
cassé	VER	m
casses	VER	na
cassée	VER	f
cassées	VER	f
cassés	VER	m
cassa	VER	na
casseriez	VER	na
cassai	VER	na
casserons	VER	na
casseront	VER	na
cassons	VER	na
cassais	VER	na
cassiez	VER	na
cassera	VER	na
prochain	ADJ	m
prochaine	ADJ	f
prochaines	ADJ	f
prochains	ADJ	m
frapperons	VER	na
frapperont	VER	na
frapper	VER	na
frappera	VER	na
frappais	VER	na
frapperais	VER	na
frappa	VER	na
frapperas	VER	na
frapperez	VER	na
frapperiez	VER	na
frappes	VER	na
frappent	VER	na
frappèrent	VER	na
frappant	VER	na
frappe	VER	na
frapperaient	VER	na
frappions	VER	na
frappons	VER	na
frappaient	VER	na
frappât	VER	na
frappé	VER	m
frapperait	VER	na
frappée	VER	f
frappiez	VER	na
frappées	VER	f
frappés	VER	m
frappez	VER	na
frappai	VER	na
frappait	VER	na
frapperai	VER	na
faciles	ADJ	na
facile	ADJ	na
attention	ONO	na
rêves	NOM	m
rêve	NOM	m
copines	NOM	f
copine	NOM	f
copain	NOM	m
copains	NOM	m
attentions	NOM	f
attention	NOM	f
malades	ADJ	na
malade	ADJ	na
rue	NOM	f
rues	NOM	na
lettres	NOM	f
lettre	NOM	f
ignorerait	VER	na
ignoreriez	VER	na
ignoreras	VER	na
ignorera	VER	na
ignorerais	VER	na
ignorerons	VER	na
ignorerai	VER	na
ignoré	VER	m
ignorer	VER	na
ignoreraient	VER	na
ignorez	VER	na
ignoreront	VER	na
ignores	VER	na
ignorés	VER	m
ignore	VER	na
ignoriez	VER	na
ignorions	VER	na
ignorons	VER	na
ignorées	VER	f
ignorée	VER	f
ignorât	VER	na
ignorent	VER	na
ignorèrent	VER	na
ignorassent	VER	na
ignora	VER	na
ignorai	VER	na
ignoraient	VER	na
ignorais	VER	na
ignorait	VER	na
ignorant	VER	na
fête	NOM	f
fêtes	NOM	f
coupaient	VER	na
coupes	VER	na
coupai	VER	na
coupez	VER	na
coupèrent	VER	na
coupons	VER	na
coupiez	VER	na
coupés	VER	m
coupions	VER	na
coupé	VER	m
coupa	VER	na
coupées	VER	f
coupais	VER	na
coupait	VER	na
esprit	NOM	m
couperait	VER	na
couperas	VER	na
couperez	VER	na
couperais	VER	na
couperaient	VER	na
couperai	VER	na
couperons	VER	na
couperont	VER	na
coupera	VER	na
couper	VER	na
coupent	VER	na
coupe	VER	na
esprits	NOM	m
coupant	VER	na
coupée	VER	f
super	ADJ	na
tairaient	VER	na
taira	VER	na
tairai	VER	na
tairas	VER	na
tairait	VER	na
tairais	VER	na
tairez	VER	na
tu	VER	m
tût	VER	na
taisiez	VER	na
taises	VER	na
taisions	VER	na
taisons	VER	na
tait	VER	na
taisent	VER	na
taise	VER	na
taisant	VER	na
taisait	VER	na
taisais	VER	na
turent	VER	na
taisaient	VER	na
taire	VER	na
tûmes	VER	na
tais	VER	na
tairont	VER	na
tairons	VER	na
tus	VER	m
tairions	VER	na
tussent	VER	na
taisez	VER	na
tut	VER	na
seigneurs	NOM	m
seigneur	NOM	m
flic	NOM	m
flics	NOM	m
parfois	ADV	na
capitaines	NOM	m
capitaine	NOM	m
âge	NOM	m
âges	NOM	m
autant	ADV	na
forces	NOM	f
force	NOM	f
pièces	NOM	f
pièce	NOM	f
quatre	ADJ:num	na
culs	NOM	m
cul	NOM	m
difficile	ADJ	na
difficiles	ADJ	na
bras	NOM	m
trompés	VER	m
trompées	VER	f
tromper	VER	na
trompée	VER	f
tromperas	VER	na
trompant	VER	na
trompent	VER	na
trompait	VER	na
trompâmes	VER	na
trompais	VER	na
tromperaient	VER	na
tromperais	VER	na
tromperait	VER	na
tromperez	VER	na
trompât	VER	na
tromperiez	VER	na
tromperons	VER	na
tromperont	VER	na
trompons	VER	na
trompaient	VER	na
trompions	VER	na
trompes	VER	na
trompez	VER	na
trompe	VER	na
tromperai	VER	na
trompèrent	VER	na
trompiez	VER	na
trompé	VER	m
trompai	VER	na
trompera	VER	na
trompa	VER	na
surtout	ADV	na
ressemblerais	VER	na
ressemble	VER	na
ressembleront	VER	na
ressemblerai	VER	na
ressemblant	VER	na
ressemblassent	VER	na
ressembles	VER	na
ressemblais	VER	na
ressemblez	VER	na
ressembliez	VER	na
ressemblions	VER	na
ressemblera	VER	na
ressemblent	VER	na
ressembler	VER	na
ressembleraient	VER	na
ressemblons	VER	na
ressemblât	VER	na
ressemblèrent	VER	na
ressemblé	VER	m
ressemblerait	VER	na
ressemblait	VER	na
ressemblerez	VER	na
ressemblaient	VER	na
ressembla	VER	na
ressembleras	VER	na
jurent	VER	na
jureras	VER	na
jurerait	VER	na
jurerais	VER	na
jurerai	VER	na
jurera	VER	na
jurer	VER	na
jurant	VER	na
jure	VER	na
jureriez	VER	na
jurait	VER	na
jurais	VER	na
juraient	VER	na
jurai	VER	na
jura	VER	na
jurerez	VER	na
jureront	VER	na
jurées	VER	f
jurez	VER	na
juriez	VER	na
jurons	VER	na
jurâmes	VER	na
jurèrent	VER	na
juré	VER	m
jurée	VER	f
jures	VER	na
jurés	VER	m
plan	NOM	m
plans	NOM	m
prisons	NOM	f
prison	NOM	f
depuis	ADV	na
sales	ADJ	na
sale	ADJ	na
courue	VER	f
couru	VER	m
courussent	VER	na
courus	VER	m
courras	VER	na
courut	VER	na
courûmes	VER	na
coure	VER	na
courent	VER	na
coures	VER	na
courez	VER	na
courûtes	VER	na
courût	VER	na
courions	VER	na
courir	VER	na
courons	VER	na
courra	VER	na
courrai	VER	na
courraient	VER	na
courrais	VER	na
courrait	VER	na
courrez	VER	na
courriez	VER	na
courrions	VER	na
courrons	VER	na
courront	VER	na
cours	VER	na
court	VER	na
couriez	VER	na
courues	VER	f
couraient	VER	na
coururent	VER	na
courant	VER	na
courait	VER	na
courais	VER	na
premières	NOM	f
premiers	NOM	m
premier	NOM	m
première	NOM	f
vieux	NOM	m
vieilles	NOM	f
vieille	NOM	f
état	NOM	m
états	NOM	m
remettrions	VER	na
remettions	VER	na
remettrai	VER	na
remettra	VER	na
remettons	VER	na
remettiez	VER	na
remettrais	VER	na
remettez	VER	na
remettes	VER	na
remettent	VER	na
remette	VER	na
remettant	VER	na
remettait	VER	na
remettriez	VER	na
remettraient	VER	na
remettrez	VER	na
remettrait	VER	na
remettras	VER	na
remettre	VER	na
remets	VER	na
remît	VER	na
remîmes	VER	na
remit	VER	na
remisse	VER	na
remises	VER	f
remise	VER	f
remis	VER	m
remirent	VER	na
remettront	VER	na
remettrons	VER	na
remettaient	VER	na
remettais	VER	na
remet	VER	na
cartes	NOM	f
carte	NOM	f
paix	NOM	f
noires	ADJ	f
noire	ADJ	f
noir	ADJ	m
noirs	ADJ	m
exactement	ADV	na
drôles	ADJ	na
drôle	ADJ	na
refusent	VER	na
refusât	VER	na
refuses	VER	na
refusez	VER	na
refusiez	VER	na
refusions	VER	na
refusons	VER	na
refusé	VER	m
refusèrent	VER	na
refuserions	VER	na
refusée	VER	f
refusées	VER	f
refusés	VER	m
refusai	VER	na
refusa	VER	na
refuser	VER	na
refuseront	VER	na
refuseriez	VER	na
refusant	VER	na
refusera	VER	na
refuserai	VER	na
refuseraient	VER	na
refuserais	VER	na
refuserait	VER	na
re-fuse	VER	na
refuseras	VER	na
refuse	VER	na
refusait	VER	na
refuserez	VER	na
refusais	VER	na
refusaient	VER	na
dès	PRE	na
président	NOM	m
présidents	NOM	m
présidentes	NOM	f
présidente	NOM	f
cours	NOM	na
graves	ADJ	na
grave	ADJ	na
termina	VER	na
termine	VER	na
terminent	VER	na
terminaient	VER	na
terminais	VER	na
terminait	VER	na
terminai	VER	na
terminées	VER	f
terminée	VER	f
terminé	VER	m
terminèrent	VER	na
terminât	VER	na
terminons	VER	na
terminions	VER	na
terminiez	VER	na
terminez	VER	na
termines	VER	na
termineront	VER	na
terminerons	VER	na
terminerez	VER	na
termineras	VER	na
terminerait	VER	na
termineraient	VER	na
terminerai	VER	na
terminera	VER	na
terminer	VER	na
terminés	VER	m
terminant	VER	na
ciels	NOM	m
ciel	NOM	m
partout	ADV	na
âmes	NOM	f
âme	NOM	f
patron	NOM	m
patronne	NOM	f
patronnes	NOM	f
patrons	NOM	m
amusait	VER	na
amusais	VER	na
amuserais	VER	na
amuse	VER	na
amusaient	VER	na
amusai	VER	na
amusent	VER	na
amuser	VER	na
amusera	VER	na
amuserai	VER	na
amuseraient	VER	na
amuserait	VER	na
amuseras	VER	na
amuserez	VER	na
amusés	VER	m
amusées	VER	f
amusée	VER	f
amusé	VER	m
amusèrent	VER	na
amusât	VER	na
amusâmes	VER	na
amusons	VER	na
amusions	VER	na
amusiez	VER	na
amusez	VER	na
amuses	VER	na
amuseront	VER	na
amuserons	VER	na
amuseriez	VER	na
amusa	VER	na
amusant	VER	na
celle	PRO:dem	f
visages	NOM	m
visage	NOM	m
intéresses	VER	na
intéresseraient	VER	na
intéresserais	VER	na
intéresserait	VER	na
intéresseras	VER	na
intéresseriez	VER	na
intéresserons	VER	na
intéresseront	VER	na
intéressez	VER	na
intéressera	VER	na
intéressiez	VER	na
intéressions	VER	na
intéressât	VER	na
intéressèrent	VER	na
intéressé	VER	m
intéressée	VER	f
intéressées	VER	f
intéressés	VER	m
intéresserai	VER	na
intéressons	VER	na
intéresser	VER	na
intéressa	VER	na
intéressent	VER	na
intéresse	VER	na
intéressai	VER	na
intéressaient	VER	na
intéressais	VER	na
intéressait	VER	na
intéressant	VER	na
reconnaissiez	VER	na
reconnaisse	VER	na
reconnaissent	VER	na
reconnaisses	VER	na
reconnaissez	VER	na
reconnussent	VER	na
re-connaître	VER	na
reconnaissions	VER	na
reconnut	VER	na
reconnûmes	VER	na
reconnût	VER	na
reconnaîtrai	VER	na
reconnaît	VER	na
reconnaîtra	VER	na
reconnaîtraient	VER	na
reconnue	VER	f
reconnaîtrais	VER	na
reconnues	VER	f
reconnurent	VER	na
reconnu	VER	m
reconnaîtront	VER	na
reconnaîtrons	VER	na
reconnus	VER	m
reconnusse	VER	na
reconnaîtriez	VER	na
reconnaîtrez	VER	na
reconnaître	VER	na
reconnaîtras	VER	na
reconnais	VER	na
reconnaissaient	VER	na
reconnaissais	VER	na
reconnaissait	VER	na
reconnaîtrait	VER	na
reconnaissant	VER	na
reconnaîtrions	VER	na
reconnaissons	VER	na
rions	VER	na
riraient	VER	na
riaient	VER	na
rirais	VER	na
rirait	VER	na
rire	VER	na
rit	VER	na
riras	VER	na
ri	VER	m
riions	VER	na
ris	VER	na
riront	VER	na
rirons	VER	na
rîmes	VER	na
rirent	VER	na
riais	VER	na
rirez	VER	na
rît	VER	na
rirai	VER	na
riiez	VER	na
riez	VER	na
ries	VER	na
rient	VER	na
rie	VER	na
riant	VER	na
rira	VER	na
riait	VER	na
médecin	NOM	m
médecins	NOM	m
rapport	NOM	m
rapports	NOM	m
pardonnerons	VER	na
pardonneriez	VER	na
pardonnent	VER	na
pardonner	VER	na
pardonnera	VER	na
pardonnerai	VER	na
pardonneront	VER	na
pardonne	VER	na
pardonneraient	VER	na
pardonnerais	VER	na
pardonnerait	VER	na
pardonneras	VER	na
pardonnerez	VER	na
pardonna	VER	na
pardonnant	VER	na
pardonnaient	VER	na
pardonnât	VER	na
pardonnés	VER	m
pardonnions	VER	na
pardonnons	VER	na
pardonniez	VER	na
pardonnez	VER	na
pardonnes	VER	na
pardonnèrent	VER	na
pardonné	VER	m
pardonnée	VER	f
pardonnait	VER	na
pardonnées	VER	f
pardonnais	VER	na
avis	NOM	m
embrasse	VER	na
embrasserai	VER	na
embrassera	VER	na
embrasser	VER	na
embrassent	VER	na
embrassa	VER	na
embrassant	VER	na
embrassait	VER	na
embrassais	VER	na
embrassai	VER	na
embrasserais	VER	na
embrasseraient	VER	na
embrasses	VER	na
embrasserait	VER	na
embrassâmes	VER	na
embrassés	VER	m
embrassées	VER	f
embrassée	VER	f
embrassé	VER	m
embrassâtes	VER	na
embrassât	VER	na
embrassons	VER	na
embrasseras	VER	na
embrassions	VER	na
embrassiez	VER	na
embrassez	VER	na
embrasseront	VER	na
embrasseriez	VER	na
embrasserez	VER	na
embrassèrent	VER	na
embrassaient	VER	na
retours	NOM	m
retour	NOM	m
simple	ADJ	na
simples	ADJ	na
danserons	VER	na
dansera	VER	na
danserai	VER	na
danseraient	VER	na
danserais	VER	na
danserait	VER	na
danseras	VER	na
danserez	VER	na
danseriez	VER	na
danserions	VER	na
danses	VER	na
danseront	VER	na
dansent	VER	na
dansez	VER	na
dansions	VER	na
dansons	VER	na
dansâmes	VER	na
dansèrent	VER	na
dansé	VER	m
dansée	VER	f
dansa	VER	na
danser	VER	na
dansiez	VER	na
danse	VER	na
dansant	VER	na
dansait	VER	na
dansais	VER	na
dansaient	VER	na
dansai	VER	na
ok	ADV	na
existai	VER	na
exista	VER	na
existes	VER	na
existèrent	VER	na
existât	VER	na
existons	VER	na
existeront	VER	na
existiez	VER	na
existeraient	VER	na
existerais	VER	na
existez	VER	na
existerait	VER	na
existeras	VER	na
existée	VER	f
existeriez	VER	na
existerions	VER	na
existerons	VER	na
existé	VER	m
existions	VER	na
existés	VER	m
existerai	VER	na
exister	VER	na
existe	VER	na
existant	VER	na
existait	VER	na
existera	VER	na
existais	VER	na
existaient	VER	na
existent	VER	na
différentes	ADJ	f
différents	ADJ	m
différente	ADJ	f
différent	ADJ	m
souvent	ADV	na
lumière	NOM	f
lumières	NOM	f
géniaux	ADJ	m
génial	ADJ	m
géniale	ADJ	f
géniales	ADJ	f
libres	ADJ	na
libre	ADJ	na
près	PRE	na
dollar	NOM	m
dollars	NOM	m
sûrement	ADV	na
pareil	ADJ	m
pareille	ADJ	f
pareilles	ADJ	f
pareils	ADJ	m
d'autres	ADJ:ind	na
hôpitaux	NOM	m
hôpital	NOM	m
ceci	PRO:dem	na
réussissait	VER	na
réussiras	VER	na
réussirais	VER	na
réussiraient	VER	na
réussissez	VER	na
réussissiez	VER	na
réussirai	VER	na
réussira	VER	na
réussissant	VER	na
réussies	VER	f
réussie	VER	f
réussi	VER	m
réussissions	VER	na
réussissons	VER	na
réussit	VER	na
réussîmes	VER	na
réussît	VER	na
réussirait	VER	na
réussir	VER	na
réussirent	VER	na
réussis	VER	m
réussisse	VER	na
réussissent	VER	na
réussirez	VER	na
réussissaient	VER	na
réussisses	VER	na
réussissais	VER	na
réussirons	VER	na
réussirions	VER	na
réussiront	VER	na
réussiriez	VER	na
bizarre	ADJ	na
bizarres	ADJ	na
voix	NOM	f
protégiez	VER	na
protégez	VER	na
protégerons	VER	na
protégeriez	VER	na
protégerez	VER	na
protégeras	VER	na
protégerait	VER	na
protégerais	VER	na
protégeât	VER	na
protégeraient	VER	na
protégerai	VER	na
protégera	VER	na
protégés	VER	m
protégées	VER	f
protégé	VER	m
protégée	VER	f
protégions	VER	na
protégeront	VER	na
protégeons	VER	na
protège	VER	na
protègent	VER	na
protégeaient	VER	na
protégeais	VER	na
protégeait	VER	na
protégeant	VER	na
protégeai	VER	na
protéger	VER	na
protégea	VER	na
protèges	VER	na
honneur	NOM	m
honneurs	NOM	m
tôt	ADV	na
équipe	NOM	f
équipes	NOM	f
préviendrai	VER	na
prévenaient	VER	na
prévenez	VER	na
préveniez	VER	na
prévenions	VER	na
prévenir	VER	na
prévenons	VER	na
prévenu	VER	m
prévenue	VER	f
prévenues	VER	f
prévenus	VER	m
préviendra	VER	na
prévenais	VER	na
préviendrais	VER	na
prévînt	VER	na
prévint	VER	na
prévins	VER	na
prévient	VER	na
préviens	VER	na
préviennent	VER	na
prévienne	VER	na
préviendront	VER	na
préviendrons	VER	na
préviendrez	VER	na
préviendras	VER	na
préviendrait	VER	na
préviennes	VER	na
prévenait	VER	na
prévenant	VER	na
chevaux	NOM	m
cheval	NOM	m
puis	ADV	na
ailleurs	ADV	na
maître	NOM	m
maîtres	NOM	m
avion	NOM	m
avions	NOM	m
bouts	NOM	m
bout	NOM	m
habiterais	VER	na
habiterait	VER	na
habiteras	VER	na
habitée	VER	f
habiteraient	VER	na
habiterez	VER	na
habités	VER	m
habitées	VER	f
habité	VER	m
habitera	VER	na
habitèrent	VER	na
habitât	VER	na
habitons	VER	na
habitions	VER	na
habitiez	VER	na
habitez	VER	na
habites	VER	na
habiteront	VER	na
habiterai	VER	na
habitait	VER	na
habiter	VER	na
habitais	VER	na
habita	VER	na
habitai	VER	na
habiterons	VER	na
habitent	VER	na
habitaient	VER	na
habiterions	VER	na
habitant	VER	na
habitassent	VER	na
habite	VER	na
faim	NOM	f
faims	NOM	f
ensuite	ADV	na
l'un	PRO:ind	na
froides	ADJ	f
froide	ADJ	f
froid	ADJ	m
froids	ADJ	m
normale	ADJ	f
normal	ADJ	m
normaux	ADJ	m
normales	ADJ	f
pas	NOM	na
dérangent	VER	na
dérangerais	VER	na
dérangeraient	VER	na
dérangerai	VER	na
déranger	VER	na
dérangeons	VER	na
dérangea	VER	na
dérange	VER	na
dérangeras	VER	na
dérangeassent	VER	na
dérangeant	VER	na
dérangeait	VER	na
dérangeaient	VER	na
dérangerait	VER	na
dérangera	VER	na
dérangeais	VER	na
dérangions	VER	na
dérangés	VER	m
dérangées	VER	f
dérangée	VER	f
dérangerons	VER	na
dérangé	VER	m
dérangiez	VER	na
dérangeât	VER	na
dérangez	VER	na
déranges	VER	na
dérangerez	VER	na
reprenais	VER	na
reprenaient	VER	na
reprendrions	VER	na
reprennes	VER	na
reprendrons	VER	na
reprendrait	VER	na
reprenait	VER	na
reprenant	VER	na
reprend	VER	na
reprendra	VER	na
reprendront	VER	na
reprendrai	VER	na
reprendrez	VER	na
reprendrais	VER	na
reprendriez	VER	na
reprendraient	VER	na
reprennent	VER	na
reprises	VER	f
reprends	VER	na
reprîmes	VER	na
repreniez	VER	na
reprendre	VER	na
reprenons	VER	na
reprendras	VER	na
reprirent	VER	na
repris	VER	m
reprise	VER	f
reprenez	VER	na
reprenions	VER	na
reprît	VER	na
reprenne	VER	na
reprisse	VER	na
reprissent	VER	na
reprit	VER	na
oncle	NOM	m
oncles	NOM	m
prix	NOM	m
retard	NOM	m
retards	NOM	m
détruisait	VER	na
détruirais	VER	na
détruisiez	VER	na
détruits	VER	m
détruiraient	VER	na
détruirai	VER	na
détruira	VER	na
détruisions	VER	na
détruisais	VER	na
détruisirent	VER	na
détruit	VER	m
détruisons	VER	na
détruisit	VER	na
détruisis	VER	na
détruisez	VER	na
détruises	VER	na
détruisent	VER	na
détruiront	VER	na
détruites	VER	f
détruirait	VER	na
détruisaient	VER	na
détruiras	VER	na
détruite	VER	f
détruire	VER	na
détruirez	VER	na
détruise	VER	na
détruisant	VER	na
détruis	VER	na
détruiriez	VER	na
détruirions	VER	na
détruirons	VER	na
cadeau	NOM	m
cadeaux	NOM	m
poussai	VER	na
poussa	VER	na
pousserez	VER	na
poussaient	VER	na
pousserions	VER	na
poussés	VER	m
poussées	VER	f
poussée	VER	f
poussèrent	VER	na
poussât	VER	na
poussâmes	VER	na
poussons	VER	na
poussions	VER	na
poussiez	VER	na
poussez	VER	na
pousses	VER	na
poussais	VER	na
pousserons	VER	na
pousseront	VER	na
pousseriez	VER	na
pousser	VER	na
poussait	VER	na
poussant	VER	na
poussas	VER	na
pousseras	VER	na
poussent	VER	na
pousse	VER	na
poussera	VER	na
pousserai	VER	na
pousseraient	VER	na
pousserais	VER	na
pousserait	VER	na
poussé	VER	m
face	NOM	f
faces	NOM	f
gueule	NOM	f
gueules	NOM	na
chemin	NOM	m
chemins	NOM	m
vivante	ADJ	f
vivantes	ADJ	f
vivants	ADJ	m
vivant	ADJ	m
général	NOM	m
générales	NOM	f
générale	NOM	f
généraux	NOM	m
bateaux	NOM	m
bateau	NOM	m
million	NOM	m
millions	NOM	m
sac	NOM	m
sacs	NOM	m
secondes	NOM	f
impossible	ADJ	na
impossibles	ADJ	na
seconde	NOM	f
découvriraient	VER	na
découvririez	VER	na
découvrît	VER	na
découvrirait	VER	na
découvrîmes	VER	na
découvrons	VER	na
découvriras	VER	na
découvrirent	VER	na
découvrirez	VER	na
découvrit	VER	na
découvrissent	VER	na
découvrisse	VER	na
découvris	VER	na
découvriront	VER	na
découvrirons	VER	na
découvrirais	VER	na
découvraient	VER	na
découvrirai	VER	na
découvrions	VER	na
découvrir	VER	na
découvert	VER	m
découverts	VER	m
découvrais	VER	na
découvrait	VER	na
découvrant	VER	na
découvre	VER	na
découvrent	VER	na
découvres	VER	na
découvrez	VER	na
découvriez	VER	na
découvrira	VER	na
erreur	NOM	f
erreurs	NOM	f
soleils	NOM	m
soleil	NOM	m
voyage	NOM	m
voyages	NOM	m
sauterais	VER	na
sauteront	VER	na
sautés	VER	m
sautions	VER	na
sautiez	VER	na
sautez	VER	na
sauterez	VER	na
sauterons	VER	na
sauteriez	VER	na
sauteraient	VER	na
sauteras	VER	na
sauterait	VER	na
sautons	VER	na
sautâmes	VER	na
sauta	VER	na
sautées	VER	f
sautai	VER	na
sautaient	VER	na
sautais	VER	na
sautait	VER	na
sautant	VER	na
sautât	VER	na
saute	VER	na
sauté	VER	m
sautent	VER	na
sauter	VER	na
sautera	VER	na
sautèrent	VER	na
sauterai	VER	na
sautée	VER	f
sautes	VER	na
rêvèrent	VER	na
rêvât	VER	na
rêves	VER	na
rêvent	VER	na
rêve	VER	na
rêvant	VER	na
rêvait	VER	na
rêvais	VER	na
rêvaient	VER	na
rêvai	VER	na
rêva	VER	na
rêvez	VER	na
rêviez	VER	na
rêvions	VER	na
rêvons	VER	na
rêveront	VER	na
rêver	VER	na
rêverait	VER	na
rêveraient	VER	na
rêverai	VER	na
rêvera	VER	na
rêvé	VER	m
rêvée	VER	f
rêvées	VER	f
rêvés	VER	m
détesterais	VER	na
détestiez	VER	na
détestez	VER	na
détesterait	VER	na
détestes	VER	na
détesteras	VER	na
détestions	VER	na
détesteriez	VER	na
détestait	VER	na
détestée	VER	f
détestent	VER	na
déteste	VER	na
détestant	VER	na
détesteraient	VER	na
détestais	VER	na
détestaient	VER	na
détestai	VER	na
détesta	VER	na
détesté	VER	m
détestât	VER	na
détestons	VER	na
détester	VER	na
détestera	VER	na
détesterai	VER	na
détesteront	VER	na
détestés	VER	m
claire	ADJ	f
clair	ADJ	m
claires	ADJ	f
clairs	ADJ	m
cons	NOM	m
connes	NOM	f
con	NOM	m
conne	NOM	f
fausse	ADJ	f
faux	ADJ	m
fausses	ADJ	f
paraîtront	VER	na
paraisse	VER	na
paru	VER	m
parais	VER	na
paraissaient	VER	na
parue	VER	f
parurent	VER	na
parus	VER	m
parussent	VER	na
parut	VER	na
paraîtrez	VER	na
parût	VER	na
paraissais	VER	na
paraissait	VER	na
paraissant	VER	na
paraîtraient	VER	na
paraître	VER	na
paraît	VER	na
paraissent	VER	na
paraîtras	VER	na
paraîtrait	VER	na
paraîtrais	VER	na
paraîtra	VER	na
paraîtrai	VER	na
paraissons	VER	na
paraissions	VER	na
paraissiez	VER	na
paraissez	VER	na
balle	NOM	f
balles	NOM	f
empêchèrent	VER	na
empêchant	VER	na
empêchât	VER	na
empêchait	VER	na
empêchais	VER	na
empêchions	VER	na
empêcheront	VER	na
empêches	VER	na
empêchaient	VER	na
empêchez	VER	na
empêcha	VER	na
empêchai	VER	na
empêchons	VER	na
empêche	VER	na
empêcherez	VER	na
empêcherons	VER	na
empêcherai	VER	na
empêcheraient	VER	na
empêcher	VER	na
empêcherais	VER	na
empêchent	VER	na
empêcherait	VER	na
empêchés	VER	m
empêcheras	VER	na
empêchées	VER	f
empêchera	VER	na
empêchée	VER	f
empêché	VER	m
maintenez	VER	na
maintiendrait	VER	na
maintenus	VER	m
maintenait	VER	na
maintenant	VER	na
maintenues	VER	f
maintiendra	VER	na
maintenue	VER	f
maintiendrai	VER	na
mainteniez	VER	na
maintenu	VER	m
maintenons	VER	na
maintenir	VER	na
maintenions	VER	na
maintiendras	VER	na
maintenais	VER	na
maintînt	VER	na
maintiendraient	VER	na
maintint	VER	na
maintiendriez	VER	na
maintiennes	VER	na
maintiennent	VER	na
maintienne	VER	na
maintiens	VER	na
maintinrent	VER	na
maintins	VER	na
maintient	VER	na
maintiendront	VER	na
maintenaient	VER	na
maintiendrons	VER	na
cheveu	NOM	m
cheveux	NOM	m
papier	NOM	m
papiers	NOM	m
sujet	NOM	m
sujets	NOM	m
supposé	VER	m
supposèrent	VER	na
supposâmes	VER	na
supposeront	VER	na
supposons	VER	na
supposions	VER	na
supposés	VER	m
supposiez	VER	na
supposez	VER	na
supposes	VER	na
supposera	VER	na
supposerait	VER	na
supposer	VER	na
supposerai	VER	na
supposais	VER	na
suppose	VER	na
supposant	VER	na
supposée	VER	f
supposent	VER	na
supposait	VER	na
supposa	VER	na
supposai	VER	na
supposaient	VER	na
supposées	VER	f
tranquille	ADJ	na
tranquilles	ADJ	na
épouse	VER	na
épouserons	VER	na
épousaient	VER	na
épousais	VER	na
épousait	VER	na
épousiez	VER	na
épousez	VER	na
épouses	VER	na
épouseront	VER	na
épousant	VER	na
épousent	VER	na
épouseriez	VER	na
épouserez	VER	na
épouserait	VER	na
épouserais	VER	na
épouseraient	VER	na
épouserai	VER	na
épousera	VER	na
épouser	VER	na
épouseras	VER	na
épousions	VER	na
épousai	VER	na
épousèrent	VER	na
épousât	VER	na
épousée	VER	f
épousons	VER	na
épousées	VER	f
épousa	VER	na
épousés	VER	m
épousé	VER	m
blancs	ADJ	m
blanches	ADJ	f
blanche	ADJ	f
blanc	ADJ	m
tables	NOM	f
table	NOM	f
toute	ADJ:ind	f
dix	ADJ:num	na
clés	NOM	f
clé	NOM	f
agent	NOM	m
agente	NOM	f
agents	NOM	m
pouvoir	NOM	m
pouvoirs	NOM	m
approcherez	VER	na
approchaient	VER	na
approchais	VER	na
approchiez	VER	na
approchez	VER	na
approcherais	VER	na
approcher	VER	na
approcherait	VER	na
approcheras	VER	na
approchera	VER	na
approches	VER	na
approcheront	VER	na
approcherons	VER	na
approcherions	VER	na
approchait	VER	na
approcherai	VER	na
approchions	VER	na
approchant	VER	na
approchons	VER	na
approchâmes	VER	na
approchât	VER	na
approchèrent	VER	na
approché	VER	m
approcha	VER	na
approchassent	VER	na
approchai	VER	na
approchée	VER	f
approchées	VER	f
approchés	VER	m
approchent	VER	na
approche	VER	na
sens	NOM	m
craignez	VER	na
craignes	VER	na
craigniez	VER	na
craindra	VER	na
craignions	VER	na
craignirent	VER	na
craignis	VER	na
craignissent	VER	na
craignit	VER	na
craignons	VER	na
craignît	VER	na
craigne	VER	na
craindrai	VER	na
craindraient	VER	na
craindrais	VER	na
craindrait	VER	na
craindras	VER	na
craignent	VER	na
craintes	VER	f
craignant	VER	na
craindront	VER	na
craint	VER	m
crainte	VER	f
craignait	VER	na
craindrons	VER	na
craints	VER	m
crains	VER	na
craindriez	VER	na
craindre	VER	na
craignaient	VER	na
craignais	VER	na
six	ADJ:num	na
message	NOM	m
messages	NOM	m
cria	VER	na
criais	VER	na
criée	VER	f
criés	VER	m
criées	VER	f
criaient	VER	na
crié	VER	m
criait	VER	na
criai	VER	na
cries	VER	na
criant	VER	na
crie	VER	na
crier	VER	na
criera	VER	na
crierai	VER	na
crieraient	VER	na
crierais	VER	na
crierait	VER	na
crieras	VER	na
crieront	VER	na
crient	VER	na
crièrent	VER	na
crions	VER	na
criez	VER	na
criions	VER	na
criât	VER	na
salles	NOM	f
salle	NOM	f
invitai	VER	na
inviterait	VER	na
inviterions	VER	na
inviteriez	VER	na
inviterons	VER	na
invités	VER	m
invitées	VER	f
inviterez	VER	na
inviteras	VER	na
invité	VER	m
inviterais	VER	na
invitaient	VER	na
invitée	VER	f
invita	VER	na
invitât	VER	na
inviterai	VER	na
invitera	VER	na
inviter	VER	na
invitent	VER	na
invite	VER	na
invitant	VER	na
invitait	VER	na
invitais	VER	na
inviteraient	VER	na
invitèrent	VER	na
invitâmes	VER	na
invitez	VER	na
invitons	VER	na
inviteront	VER	na
invitions	VER	na
invitiez	VER	na
invites	VER	na
effet	NOM	m
effets	NOM	m
réfléchissiez	VER	na
réfléchissons	VER	na
réfléchît	VER	na
réfléchiras	VER	na
réfléchissais	VER	na
réfléchi	VER	m
réfléchie	VER	f
réfléchies	VER	f
réfléchir	VER	na
réfléchira	VER	na
réfléchirai	VER	na
réfléchirais	VER	na
réfléchirait	VER	na
réfléchissaient	VER	na
réfléchit	VER	na
réfléchirons	VER	na
réfléchissent	VER	na
réfléchisse	VER	na
réfléchissant	VER	na
réfléchissez	VER	na
réfléchis	VER	m
réfléchiront	VER	na
réfléchisses	VER	na
réfléchirez	VER	na
réfléchiriez	VER	na
réfléchissait	VER	na
réfléchirent	VER	na
espèce	NOM	f
espèces	NOM	f
arrangeât	VER	na
arrangez	VER	na
arranges	VER	na
arrangerez	VER	na
arrangeront	VER	na
arrangés	VER	m
arrangerons	VER	na
arrange	VER	na
arrangée	VER	f
arrangent	VER	na
arrangées	VER	f
arrangerais	VER	na
arrangerions	VER	na
arrangeons	VER	na
arrangeraient	VER	na
arrangera	VER	na
arrangeras	VER	na
arrangerait	VER	na
arrangé	VER	m
arrangerai	VER	na
arranger	VER	na
arrangeai	VER	na
arrangeaient	VER	na
arrangeais	VER	na
arrangeait	VER	na
arrangeant	VER	na
arrangèrent	VER	na
arrangions	VER	na
arrangea	VER	na
arrangiez	VER	na
naquisse	VER	na
naquis	VER	na
naquissent	VER	na
naîtraient	VER	na
naître	VER	na
naîtrait	VER	na
naîtrai	VER	na
naîtra	VER	na
naît	VER	na
naquit	VER	na
naquît	VER	na
naîtront	VER	na
naquirent	VER	na
nais	VER	na
naissez	VER	na
naisses	VER	na
naissent	VER	na
naisse	VER	na
naissant	VER	na
naissait	VER	na
naissais	VER	na
naissaient	VER	na
naissions	VER	na
naissons	VER	na
naîtrions	VER	na
né	VER	m
née	VER	f
nées	VER	f
nés	VER	m
allô	ONO	na
passées	ADJ	f
passé	ADJ	m
passés	ADJ	m
passée	ADJ	f
bois	NOM	m
propos	NOM	m
camp	NOM	m
camps	NOM	m
sortes	NOM	f
sorte	NOM	f
hôtels	NOM	m
hôtel	NOM	m
débuts	NOM	m
début	NOM	m
souffrirez	VER	na
souffriras	VER	na
souffrissent	VER	na
souffrit	VER	na
souffrons	VER	na
souffrisse	VER	na
souffrant	VER	na
souffrirais	VER	na
souffrirons	VER	na
souffririons	VER	na
souffriront	VER	na
souffrirent	VER	na
souffrît	VER	na
souffrirait	VER	na
souffriraient	VER	na
soufferts	VER	m
souffrait	VER	na
souffrais	VER	na
souffris	VER	na
souffre	VER	na
souffrent	VER	na
souffres	VER	na
souffrez	VER	na
souffraient	VER	na
souffrirai	VER	na
souffriez	VER	na
souffertes	VER	f
soufferte	VER	f
souffert	VER	m
souffririez	VER	na
souffrions	VER	na
souffrir	VER	na
souffrira	VER	na
jambe	NOM	f
jambes	NOM	f
remercieront	VER	na
remercies	VER	na
remercierons	VER	na
remerciez	VER	na
remercierez	VER	na
remercions	VER	na
remercia	VER	na
remercieras	VER	na
remerciée	VER	f
remercié	VER	m
remerciai	VER	na
remerciaient	VER	na
remerciais	VER	na
remerciait	VER	na
remerciant	VER	na
remercient	VER	na
remercier	VER	na
remercierait	VER	na
remerciés	VER	m
remercièrent	VER	na
remerciâmes	VER	na
remerciera	VER	na
remercierai	VER	na
remercierais	VER	na
remercie	VER	na
choix	NOM	m
sécurité	NOM	f
sécurités	NOM	f
baisaient	VER	na
baisèrent	VER	na
baiserons	VER	na
baiseront	VER	na
baises	VER	na
baiserait	VER	na
baiserais	VER	na
baiseraient	VER	na
baisez	VER	na
baisiez	VER	na
baisions	VER	na
baiserai	VER	na
baisons	VER	na
baisera	VER	na
baiser	VER	na
baisent	VER	na
baise	VER	na
baisant	VER	na
baisait	VER	na
baisais	VER	na
baisa	VER	na
baisai	VER	na
baisés	VER	m
baisées	VER	f
baisée	VER	f
baisé	VER	m
baiseras	VER	na
baiserez	VER	na
baiseriez	VER	na
avocat	NOM	m
avocate	NOM	f
avocates	NOM	f
avocats	NOM	m
attraperiez	VER	na
attrapent	VER	na
attraperait	VER	na
attraperais	VER	na
attraperaient	VER	na
attraperai	VER	na
attrapera	VER	na
attraper	VER	na
attrapait	VER	na
attrapant	VER	na
attraperez	VER	na
attrapais	VER	na
attrapaient	VER	na
attrapai	VER	na
attrapa	VER	na
attraperas	VER	na
attrape	VER	na
attrapé	VER	m
attraperont	VER	na
attrapes	VER	na
attrapez	VER	na
attrapiez	VER	na
attrapions	VER	na
attrapons	VER	na
attrapèrent	VER	na
attraperons	VER	na
attrapée	VER	f
attrapées	VER	f
attrapés	VER	m
clientes	NOM	f
cliente	NOM	f
clients	NOM	m
client	NOM	m
courant	NOM	m
courants	NOM	m
dépêchons	VER	na
dépêchât	VER	na
dépêches	VER	na
dépêchant	VER	na
dépêche	VER	na
dépêchait	VER	na
dépêchais	VER	na
dépêchaient	VER	na
dépêchai	VER	na
dépêcher	VER	na
dépêchent	VER	na
dépêcherais	VER	na
dépêcherons	VER	na
dépêchez	VER	na
dépêchions	VER	na
dépêchèrent	VER	na
dépêcha	VER	na
dépêché	VER	m
dépêchée	VER	f
dépêchées	VER	f
dépêchés	VER	m
peuples	NOM	m
peuple	NOM	m
dame	NOM	f
dames	NOM	f
dessus	ADV	na
abandonniez	VER	na
abandonnions	VER	na
abandonnées	VER	f
abandonnons	VER	na
abandonnâmes	VER	na
abandonnât	VER	na
abandonnèrent	VER	na
abandonné	VER	m
abandonnée	VER	f
abandonnés	VER	m
vérifiais	VER	na
abandonnez	VER	na
abandonneront	VER	na
vérifiaient	VER	na
abandonnes	VER	na
abandonnaient	VER	na
abandonnais	VER	na
abandonnait	VER	na
abandonnant	VER	na
abandonnas	VER	na
abandonne	VER	na
abandonnent	VER	na
abandonner	VER	na
abandonnera	VER	na
abandonnerai	VER	na
abandonneraient	VER	na
abandonnerais	VER	na
abandonnerait	VER	na
abandonneras	VER	na
abandonnerez	VER	na
abandonneriez	VER	na
abandonnerions	VER	na
abandonnerons	VER	na
vérifiant	VER	na
vérifia	VER	na
vérifiai	VER	na
vérifiait	VER	na
vérifient	VER	na
vérifie	VER	na
vérifiez	VER	na
abandonna	VER	na
vérifiés	VER	m
vérifiées	VER	f
vérifiée	VER	f
vérifié	VER	m
vérifièrent	VER	na
vérifions	VER	na
vérifiions	VER	na
abandonnai	VER	na
vérifies	VER	na
vérifierons	VER	na
vérifieras	VER	na
vérifierait	VER	na
vérifierais	VER	na
vérifierai	VER	na
vérifiera	VER	na
vérifieront	VER	na
vérifier	VER	na
journal	NOM	m
journaux	NOM	m
sérieuses	ADJ	f
sérieuse	ADJ	f
sérieux	ADJ	m
brûlé	VER	m
brûlerait	VER	na
brûlions	VER	na
brûlée	VER	f
brûlées	VER	f
brûlés	VER	m
brûliez	VER	na
brûlez	VER	na
brûlons	VER	na
brûlèrent	VER	na
brûles	VER	na
brûleront	VER	na
brûlerons	VER	na
brûlerez	VER	na
brûleras	VER	na
brûle	VER	na
brûlerais	VER	na
brûleraient	VER	na
brûlerai	VER	na
brûlera	VER	na
brûler	VER	na
brûlent	VER	na
brûlassent	VER	na
brûlasse	VER	na
brûlant	VER	na
brûlait	VER	na
brûlais	VER	na
brûlai	VER	na
brûla	VER	na
ors	NOM	m
or	NOM	m
brûlaient	VER	na
brûlât	VER	na
lois	NOM	f
loi	NOM	f
fond	NOM	m
gosses	NOM	na
gosse	NOM	na
fric	NOM	m
frics	NOM	m
situations	NOM	f
situation	NOM	f
euh	ONO	na
sauf	PRE	na
accidents	NOM	m
accident	NOM	m
doute	NOM	m
doutes	NOM	m
scène	NOM	f
scènes	NOM	f
soldats	NOM	m
soldate	NOM	f
soldat	NOM	m
amoureuses	ADJ	f
amoureux	ADJ	m
amoureuse	ADJ	f
assuriez	VER	na
assurèrent	VER	na
assurait	VER	na
assurât	VER	na
assuré	VER	m
assurée	VER	f
assurées	VER	f
assurés	VER	m
assurons	VER	na
assurions	VER	na
assurant	VER	na
assurez	VER	na
assurerai	VER	na
assurais	VER	na
assuraient	VER	na
assurai	VER	na
assures	VER	na
assurassent	VER	na
assure	VER	na
assurent	VER	na
assurer	VER	na
assurera	VER	na
assura	VER	na
assureraient	VER	na
assurerais	VER	na
assurerait	VER	na
assureras	VER	na
assurerez	VER	na
assurerons	VER	na
assureront	VER	na
preuves	NOM	f
preuve	NOM	f
humains	ADJ	m
humain	ADJ	m
humaines	ADJ	f
humaine	ADJ	f
mer	NOM	f
mers	NOM	f
biens	NOM	m
bien	NOM	m
silence	NOM	m
silences	NOM	m
télés	NOM	f
télé	NOM	f
victime	NOM	f
victimes	NOM	f
complètement	ADV	na
pute	NOM	f
putes	NOM	f
calme	NOM	m
calmes	NOM	m
derrière	PRE	na
garde	NOM	na
gardes	NOM	na
meurtre	NOM	m
meurtres	NOM	m
groupes	NOM	m
groupe	NOM	m
crime	NOM	m
crimes	NOM	m
traitons	VER	na
traiteras	VER	na
traitées	VER	f
traitions	VER	na
traiteraient	VER	na
traitait	VER	na
traitais	VER	na
traitai	VER	na
traitaient	VER	na
traiteriez	VER	na
traita	VER	na
traités	VER	m
traiterais	VER	na
traiterait	VER	na
traiterez	VER	na
traitant	VER	na
traitent	VER	na
traité	VER	m
traitiez	VER	na
traitez	VER	na
traitassent	VER	na
traiterai	VER	na
traitât	VER	na
traitèrent	VER	na
traites	VER	na
traite	VER	na
traiteront	VER	na
traiterons	VER	na
traitée	VER	f
traiter	VER	na
traitera	VER	na
doucement	ADV	na
blessèrent	VER	na
blessez	VER	na
blessiez	VER	na
blessât	VER	na
blesseront	VER	na
blessé	VER	m
blessée	VER	f
blessées	VER	f
blessés	VER	m
blesses	VER	na
blesseras	VER	na
blesserons	VER	na
blesser	VER	na
blessa	VER	na
blessaient	VER	na
blessais	VER	na
blessait	VER	na
blessant	VER	na
blessent	VER	na
blesse	VER	na
blessera	VER	na
blesserai	VER	na
blesseraient	VER	na
blesserais	VER	na
blesserait	VER	na
blesserez	VER	na
blesseriez	VER	na
colonels	NOM	m
colonelle	NOM	f
colonel	NOM	m
certains	ADJ	m
certain	ADJ:ind	m
certain	ADJ	m
certaines	ADJ	f
certaine	ADJ	f
secrets	NOM	m
secret	NOM	m
parole	NOM	f
paroles	NOM	f
tristes	ADJ	na
triste	ADJ	na
honte	NOM	f
hontes	NOM	f
rouges	ADJ	na
rouge	ADJ	na
dégagée	VER	f
dégageait	VER	na
dégagea	VER	na
dégagés	VER	m
dégage	VER	na
dégageai	VER	na
dégageaient	VER	na
dégageât	VER	na
dégagées	VER	f
dégagera	VER	na
dégageront	VER	na
dégageant	VER	na
dégageons	VER	na
dégager	VER	na
dégageraient	VER	na
dégagerais	VER	na
dégagerait	VER	na
dégagent	VER	na
dégages	VER	na
dégagez	VER	na
dégagèrent	VER	na
dégagé	VER	m
seules	NOM	f
seul	NOM	m
seule	NOM	f
seuls	NOM	m
soirée	NOM	f
soirées	NOM	f
bon	NOM	m
bons	NOM	m
dangereux	ADJ	m
dangereuse	ADJ	f
dangereuses	ADJ	f
armée	NOM	f
armées	NOM	f
filés	VER	m
filions	VER	na
filaient	VER	na
filerais	VER	na
filent	VER	na
filant	VER	na
filèrent	VER	na
filé	VER	m
file	VER	na
filez	VER	na
filait	VER	na
filais	VER	na
filiez	VER	na
fileras	VER	na
files	VER	na
filât	VER	na
filâmes	VER	na
filons	VER	na
fila	VER	na
filer	VER	na
fileront	VER	na
filera	VER	na
filerai	VER	na
filai	VER	na
filerez	VER	na
filées	VER	f
filerons	VER	na
fileriez	VER	na
filée	VER	f
filerait	VER	na
fileraient	VER	na
être	NOM	m
êtres	NOM	m
risqués	VER	m
risqué	VER	m
risques	VER	na
risquât	VER	na
risquons	VER	na
risquions	VER	na
risquées	VER	f
risquiez	VER	na
risquée	VER	f
risquez	VER	na
risqueront	VER	na
risquerions	VER	na
risqua	VER	na
risquai	VER	na
risquaient	VER	na
risquais	VER	na
risquait	VER	na
risquerez	VER	na
risqueras	VER	na
risquant	VER	na
risque	VER	na
risquent	VER	na
risquer	VER	na
risquera	VER	na
risquerai	VER	na
risqueraient	VER	na
risquerais	VER	na
risqueriez	VER	na
risquerons	VER	na
risquerait	VER	na
dos	NOM	m
appel	NOM	m
appels	NOM	m
visite	NOM	f
visites	NOM	f
mèneraient	VER	na
mène	VER	na
mènent	VER	na
mènera	VER	na
mènerai	VER	na
mènerait	VER	na
mènerais	VER	na
mèneras	VER	na
mènerez	VER	na
mènerons	VER	na
mèneront	VER	na
mènes	VER	na
menés	VER	m
menées	VER	f
mené	VER	m
menait	VER	na
menais	VER	na
menaient	VER	na
menai	VER	na
menant	VER	na
menassent	VER	na
menée	VER	f
mena	VER	na
menèrent	VER	na
menât	VER	na
mener	VER	na
menez	VER	na
meniez	VER	na
menions	VER	na
menons	VER	na
fleur	NOM	f
fleurs	NOM	f
attaquer	VER	na
attaquât	VER	na
attaquèrent	VER	na
attaqué	VER	m
attaquée	VER	f
attaquées	VER	f
attaquerait	VER	na
attaquais	VER	na
attaqués	VER	m
attaqua	VER	na
attaquai	VER	na
attaquaient	VER	na
attaquâmes	VER	na
attaquait	VER	na
attaquant	VER	na
attaque	VER	na
attaquent	VER	na
attaquera	VER	na
attaquons	VER	na
attaques	VER	na
attaquerions	VER	na
attaquerai	VER	na
attaquez	VER	na
attaqueraient	VER	na
attaquerez	VER	na
attaqueriez	VER	na
attaqueras	VER	na
attaquerais	VER	na
attaquiez	VER	na
attaqueront	VER	na
attaquerons	VER	na
coin	NOM	m
coins	NOM	m
princes	NOM	m
prince	NOM	m
princesse	NOM	f
princesses	NOM	f
pires	ADJ	na
pire	ADJ	na
bordel	NOM	m
bordels	NOM	m
professeur	NOM	na
professeure	NOM	f
professeurs	NOM	na
fumions	VER	na
fumiez	VER	na
fumons	VER	na
fumâmes	VER	na
fumât	VER	na
fumèrent	VER	na
fumé	VER	m
fumées	VER	f
fumés	VER	m
fumée	VER	f
fumais	VER	na
fumez	VER	na
fumer	VER	na
fuma	VER	na
fumai	VER	na
fumaient	VER	na
fumait	VER	na
fumant	VER	na
fume	VER	na
fumes	VER	na
fument	VER	na
fumeraient	VER	na
fumera	VER	na
fumerait	VER	na
fumeras	VER	na
fumerai	VER	na
fumerez	VER	na
fumerons	VER	na
fumerais	VER	na
répétées	VER	f
répétée	VER	f
répétât	VER	na
répétais	VER	na
répétés	VER	m
répété	VER	m
répétai	VER	na
répétait	VER	na
répéta	VER	na
répétèrent	VER	na
répétera	VER	na
répéterai	VER	na
répétions	VER	na
répétiez	VER	na
répétez	VER	na
répètes	VER	na
répéteriez	VER	na
répéterez	VER	na
répéteras	VER	na
répétant	VER	na
répéter	VER	na
répéterait	VER	na
répéterais	VER	na
répéteraient	VER	na
répétons	VER	na
répétaient	VER	na
répètent	VER	na
répète	VER	na
habitudes	NOM	f
habitude	NOM	f
signant	VER	na
signeront	VER	na
signerons	VER	na
signa	VER	na
signerions	VER	na
signeriez	VER	na
signerez	VER	na
signai	VER	na
signaient	VER	na
signait	VER	na
signerait	VER	na
signeras	VER	na
signez	VER	na
signasse	VER	na
signerais	VER	na
signeraient	VER	na
signerai	VER	na
signera	VER	na
signer	VER	na
signent	VER	na
signe	VER	na
signes	VER	na
signais	VER	na
signiez	VER	na
signèrent	VER	na
signées	VER	f
signée	VER	f
signé	VER	m
signés	VER	m
signât	VER	na
signâmes	VER	na
signons	VER	na
ficha	VER	na
ficheront	VER	na
ficherons	VER	na
ficheras	VER	na
ficherait	VER	na
ficherais	VER	na
ficheraient	VER	na
fichera	VER	na
ficherai	VER	na
fichait	VER	na
ficher	VER	na
fichent	VER	na
fichez	VER	na
fiche	VER	na
fichant	VER	na
fiches	VER	na
fichiez	VER	na
fichées	VER	f
fichât	VER	na
fichaient	VER	na
fichés	VER	m
fichée	VER	f
fiché	VER	m
fichais	VER	na
fichons	VER	na
fichions	VER	na
méritât	VER	na
méritons	VER	na
méritez	VER	na
méritions	VER	na
méritées	VER	f
méritant	VER	na
méritait	VER	na
méritais	VER	na
méritaient	VER	na
mérita	VER	na
mérité	VER	m
méritée	VER	f
mérités	VER	m
méritiez	VER	na
mériteront	VER	na
mériterais	VER	na
mériterai	VER	na
mérites	VER	na
réponses	NOM	f
mériter	VER	na
réponse	NOM	f
mériteraient	VER	na
mériteriez	VER	na
mériteras	VER	na
méritassent	VER	na
méritent	VER	na
méritera	VER	na
mérite	VER	na
mériterait	VER	na
rejoignaient	VER	na
rejoignirent	VER	na
rejoindre	VER	na
rejoignis	VER	na
rejoindrions	VER	na
rejoindrez	VER	na
rejoignions	VER	na
rejoindrons	VER	na
rejoindront	VER	na
rejoins	VER	na
rejoint	VER	m
rejointe	VER	f
rejointes	VER	f
rejoindras	VER	na
rejoindraient	VER	na
rejoindrait	VER	na
rejoindrais	VER	na
rejoignit	VER	na
rejoignons	VER	na
rejoignes	VER	na
rejoignisse	VER	na
rejoignais	VER	na
rejoignîmes	VER	na
rejoigne	VER	na
rejoignent	VER	na
rejoignît	VER	na
rejoignait	VER	na
rejoignant	VER	na
rejoindra	VER	na
rejoindrai	VER	na
rejoignez	VER	na
rejoigniez	VER	na
rejoignissent	VER	na
rejoints	VER	m
discuterez	VER	na
discutés	VER	m
discutes	VER	na
discuteront	VER	na
discuterait	VER	na
discuterais	VER	na
discutiez	VER	na
discutions	VER	na
discuterons	VER	na
discuteriez	VER	na
discutons	VER	na
discutâmes	VER	na
discutât	VER	na
discutèrent	VER	na
discuté	VER	m
discutée	VER	f
discutées	VER	f
discutait	VER	na
discutent	VER	na
discuta	VER	na
discutai	VER	na
discutaient	VER	na
discutais	VER	na
discutant	VER	na
discute	VER	na
discutez	VER	na
discuter	VER	na
discutera	VER	na
discuterai	VER	na
discuteraient	VER	na
discuterions	VER	na
villages	NOM	m
village	NOM	m
pourtant	ADV	na
avançaient	VER	na
avança	VER	na
avancés	VER	m
avancé	VER	m
avancées	VER	f
avançai	VER	na
avancée	VER	f
avançais	VER	na
avancerais	VER	na
avancèrent	VER	na
avancions	VER	na
avanciez	VER	na
avancez	VER	na
avances	VER	na
avanceront	VER	na
avancerons	VER	na
avancerez	VER	na
avancerait	VER	na
avancerai	VER	na
avancera	VER	na
avancer	VER	na
avancent	VER	na
avançait	VER	na
avançant	VER	na
avance	VER	na
avançons	VER	na
avançâmes	VER	na
avançât	VER	na
conneries	NOM	f
connerie	NOM	f
forts	ADJ	m
fort	ADJ	m
fortes	ADJ	f
forte	ADJ	f
reposés	VER	m
reposai	VER	na
reposais	VER	na
reposa	VER	na
reposées	VER	f
reposée	VER	f
reposé	VER	m
reposèrent	VER	na
reposât	VER	na
reposons	VER	na
reposions	VER	na
reposiez	VER	na
reposez	VER	na
reposes	VER	na
reposaient	VER	na
reposerons	VER	na
reposera	VER	na
reposerions	VER	na
reposant	VER	na
repose	VER	na
reposent	VER	na
reposer	VER	na
reposait	VER	na
reposerai	VER	na
reposeras	VER	na
reposeraient	VER	na
reposerez	VER	na
reposeront	VER	na
reposerait	VER	na
reposerais	VER	na
échappiez	VER	na
échapperais	VER	na
échappez	VER	na
échapperont	VER	na
échapperons	VER	na
échapperions	VER	na
échapperiez	VER	na
échapperez	VER	na
échapperas	VER	na
échapperait	VER	na
échappes	VER	na
échappai	VER	na
échapperaient	VER	na
échapperai	VER	na
échappera	VER	na
échapper	VER	na
échappent	VER	na
échappant	VER	na
échappait	VER	na
échappais	VER	na
échappaient	VER	na
échappa	VER	na
échappons	VER	na
échappions	VER	na
échappe	VER	na
échappâmes	VER	na
échappèrent	VER	na
échappé	VER	m
échappée	VER	f
échappât	VER	na
échappées	VER	f
échappés	VER	m
formes	NOM	f
forme	NOM	f
folle	NOM	f
fous	NOM	m
folles	NOM	f
fou	NOM	m
bruits	NOM	m
bruit	NOM	m
chacun	PRO:ind	m
diables	NOM	m
diable	NOM	m
exemple	NOM	m
exemples	NOM	m
chargiez	VER	na
charges	VER	na
chargez	VER	na
chargeât	VER	na
chargèrent	VER	na
chargions	VER	na
chargé	VER	m
chargée	VER	f
chargées	VER	f
chargés	VER	m
charge	VER	na
chargeait	VER	na
chargerons	VER	na
chargeons	VER	na
chargeant	VER	na
chargent	VER	na
chargeais	VER	na
chargeaient	VER	na
chargeai	VER	na
chargerez	VER	na
chargea	VER	na
charger	VER	na
chargera	VER	na
chargerai	VER	na
chargeraient	VER	na
chargerais	VER	na
chargerait	VER	na
chargeras	VER	na
chargeront	VER	na
chat	NOM	m
chatte	NOM	f
chattes	NOM	f
chats	NOM	m
ennemi	NOM	m
ennemie	NOM	f
ennemies	NOM	f
ennemis	NOM	m
grand	NOM	m
grands	NOM	m
grandes	NOM	f
grande	NOM	f
gamine	NOM	f
gamins	NOM	m
gamin	NOM	m
gamines	NOM	f
rendez-vous	NOM	m
debout	ADV	na
obligeons	VER	na
obligerait	VER	na
obligeront	VER	na
oblige	VER	na
obligea	VER	na
obligeriez	VER	na
obligerez	VER	na
obligeai	VER	na
obligeras	VER	na
obligeaient	VER	na
obliger	VER	na
obligeais	VER	na
obligerais	VER	na
obligeant	VER	na
obligerai	VER	na
obligera	VER	na
obligez	VER	na
obligent	VER	na
obliges	VER	na
obligeait	VER	na
obligèrent	VER	na
obligé	VER	m
obligée	VER	f
obligées	VER	f
obligés	VER	m
obligiez	VER	na
obligeât	VER	na
meilleure	NOM	f
meilleurs	NOM	m
meilleur	NOM	m
meilleures	NOM	f
trou	NOM	m
trous	NOM	m
idiots	NOM	m
idiotes	NOM	f
idiote	NOM	f
idiot	NOM	m
accompagnée	VER	f
accompagneras	VER	na
accompagnerait	VER	na
accompagna	VER	na
accompagnai	VER	na
accompagnaient	VER	na
accompagné	VER	m
accompagnais	VER	na
accompagnait	VER	na
accompagnerais	VER	na
accompagnant	VER	na
accompagnerons	VER	na
accompagnés	VER	m
accompagnées	VER	f
accompagneriez	VER	na
accompagnerez	VER	na
accompagneraient	VER	na
accompagneront	VER	na
accompagne	VER	na
accompagnèrent	VER	na
accompagnes	VER	na
accompagnât	VER	na
accompagnerai	VER	na
accompagnâmes	VER	na
accompagnons	VER	na
accompagnera	VER	na
accompagnez	VER	na
accompagner	VER	na
accompagnent	VER	na
accompagniez	VER	na
accompagnions	VER	na
fenêtres	NOM	f
fenêtre	NOM	f
oseront	VER	na
oserais	VER	na
oserai	VER	na
oseras	VER	na
osée	VER	f
oserait	VER	na
osé	VER	m
oseriez	VER	na
oserez	VER	na
oserions	VER	na
oses	VER	na
osèrent	VER	na
osât	VER	na
osâmes	VER	na
osons	VER	na
osions	VER	na
osiez	VER	na
osez	VER	na
oserons	VER	na
oser	VER	na
osera	VER	na
osent	VER	na
osaient	VER	na
osées	VER	f
osa	VER	na
osai	VER	na
osés	VER	m
osais	VER	na
ose	VER	na
osant	VER	na
osait	VER	na
impression	NOM	f
impressions	NOM	f
intérieur	NOM	m
intérieurs	NOM	m
bouches	NOM	f
bouche	NOM	f
lignes	NOM	f
ligne	NOM	f
absolument	ADV	na
mort	ADJ	m
morte	ADJ	f
mortes	ADJ	f
morts	ADJ	m
douce	ADJ	f
douces	ADJ	f
doux	ADJ	m
regrettiez	VER	na
regretterons	VER	na
regretteront	VER	na
regrettes	VER	na
regrettez	VER	na
regrettions	VER	na
regrettés	VER	m
regretteriez	VER	na
regrettât	VER	na
regrettèrent	VER	na
regretté	VER	m
regrettée	VER	f
regrettées	VER	f
regrettons	VER	na
regretteras	VER	na
regretterez	VER	na
regretter	VER	na
regretta	VER	na
regrettai	VER	na
regrettaient	VER	na
regrettais	VER	na
regrettait	VER	na
regrettant	VER	na
regrette	VER	na
regrettent	VER	na
regrettera	VER	na
regretterai	VER	na
regretteraient	VER	na
regretterait	VER	na
plein	PRE	na
regretterais	VER	na
mur	NOM	m
murs	NOM	m
enfer	NOM	m
enfers	NOM	m
prouver	VER	na
prouvent	VER	na
prouve	VER	na
prouverez	VER	na
prouveront	VER	na
prouveras	VER	na
prouverait	VER	na
prouveraient	VER	na
prouves	VER	na
prouvez	VER	na
prouviez	VER	na
prouvons	VER	na
prouvèrent	VER	na
prouvé	VER	m
prouvée	VER	f
prouvées	VER	f
prouvera	VER	na
prouvés	VER	m
prouvant	VER	na
prouvait	VER	na
prouvais	VER	na
prouvaient	VER	na
prouvai	VER	na
prouva	VER	na
prouverai	VER	na
prouverons	VER	na
boîtes	NOM	f
boîte	NOM	f
santé	NOM	f
santés	NOM	f
t	PRO:per	na
dîner	NOM	m
dîners	NOM	m
couvraient	VER	na
couvrirait	VER	na
couvres	VER	na
couvrent	VER	na
couvrez	VER	na
couvrait	VER	na
couvrir	VER	na
couvrira	VER	na
couvrirai	VER	na
couvriraient	VER	na
couvrirais	VER	na
couvrirent	VER	na
couvriras	VER	na
couvrant	VER	na
couvrirez	VER	na
couvrirons	VER	na
couvriront	VER	na
couvris	VER	na
couvre	VER	na
couvrit	VER	na
couvrons	VER	na
couvrît	VER	na
couvrais	VER	na
couvriez	VER	na
couverts	VER	m
couvert	VER	m
couvertes	VER	f
couverte	VER	f
magnifique	ADJ	na
magnifiques	ADJ	na
obtiendriez	VER	na
obtenue	VER	f
obtenant	VER	na
obtenez	VER	na
obteniez	VER	na
obtenions	VER	na
obtenir	VER	na
obtenons	VER	na
obtenu	VER	m
obtenus	VER	m
obtenues	VER	f
obtenais	VER	na
obtiendra	VER	na
obtiendrai	VER	na
obtiendraient	VER	na
obtiendrais	VER	na
obtiendrait	VER	na
obtiendras	VER	na
obtiendrez	VER	na
obtenait	VER	na
obtenaient	VER	na
obtient	VER	na
obtiennent	VER	na
obtiendront	VER	na
obtiendrions	VER	na
obtienne	VER	na
obtînt	VER	na
obtînmes	VER	na
obtint	VER	na
obtinsse	VER	na
obtins	VER	na
obtinrent	VER	na
obtiendrons	VER	na
obtiens	VER	na
obtiennes	VER	na
cuisines	NOM	f
cuisine	NOM	f
vue	NOM	f
vues	NOM	f
terribles	ADJ	na
terrible	ADJ	na
éviterait	VER	na
peaux	NOM	f
éviteras	VER	na
éviterez	VER	na
éviteriez	VER	na
évitez	VER	na
éviterons	VER	na
éviteront	VER	na
évites	VER	na
évitiez	VER	na
éviterais	VER	na
peau	NOM	f
évitions	VER	na
éviteraient	VER	na
évitai	VER	na
évitons	VER	na
évitâmes	VER	na
évitât	VER	na
évitèrent	VER	na
évité	VER	m
évitée	VER	f
évitées	VER	f
évités	VER	m
évita	VER	na
évitent	VER	na
évitaient	VER	na
évitant	VER	na
éviterai	VER	na
évitera	VER	na
éviter	VER	na
évitait	VER	na
évitais	VER	na
évite	VER	na
salauds	NOM	m
salaud	NOM	m
conseil	NOM	m
conseils	NOM	m
plaisanté	VER	m
plaisanterais	VER	na
plaisantent	VER	na
plaisantons	VER	na
plaisantèrent	VER	na
plaisanter	VER	na
plaisanterai	VER	na
plaisantions	VER	na
plaisante	VER	na
plaisanteraient	VER	na
plaisantiez	VER	na
plaisantez	VER	na
plaisantes	VER	na
plaisanteras	VER	na
plaisantant	VER	na
plaisantait	VER	na
plaisantais	VER	na
plaisantaient	VER	na
plaisantai	VER	na
plaisanta	VER	na
plaisanterons	VER	na
plaisantera	VER	na
autour	ADV	na
vins	NOM	m
vin	NOM	m
exacte	ADJ	f
exacts	ADJ	m
exactes	ADJ	f
exact	ADJ	m
virèrent	VER	na
vireront	VER	na
vires	VER	na
virez	VER	na
viriez	VER	na
virons	VER	na
virerez	VER	na
vireras	VER	na
virerait	VER	na
virerai	VER	na
virât	VER	na
virerais	VER	na
viré	VER	m
vire	VER	na
vira	VER	na
virai	VER	na
viraient	VER	na
virais	VER	na
virait	VER	na
virée	VER	f
virant	VER	na
virent	VER	na
virer	VER	na
virera	VER	na
virés	VER	m
virées	VER	f
supporterai	VER	na
supportera	VER	na
supporteraient	VER	na
supporte	VER	na
supportait	VER	na
supportant	VER	na
supportent	VER	na
supportais	VER	na
supportaient	VER	na
supportai	VER	na
supporta	VER	na
supporterait	VER	na
supporterais	VER	na
supporter	VER	na
supporteras	VER	na
supportiez	VER	na
supportées	VER	f
supportée	VER	f
supporté	VER	m
supportèrent	VER	na
supportât	VER	na
supporterez	VER	na
supportions	VER	na
supportons	VER	na
supportez	VER	na
supportes	VER	na
supporteront	VER	na
supporterons	VER	na
supporteriez	VER	na
supportés	VER	m
réglât	VER	na
régla	VER	na
réglée	VER	f
réglai	VER	na
réglé	VER	m
réglèrent	VER	na
réglerons	VER	na
régleras	VER	na
réglerez	VER	na
réglerions	VER	na
réglais	VER	na
régleront	VER	na
réglez	VER	na
régliez	VER	na
réglaient	VER	na
règles	VER	na
réglait	VER	na
réglant	VER	na
réglasse	VER	na
régler	VER	na
réglera	VER	na
réglerai	VER	na
réglons	VER	na
règlent	VER	na
règle	VER	na
réglerait	VER	na
réglerais	VER	na
réglées	VER	f
réglés	VER	m
réglions	VER	na
doigt	NOM	m
doigts	NOM	m
étranges	ADJ	na
grâce	PRE	na
étrange	ADJ	na
souhaité	VER	m
souhaitée	VER	f
souhaitées	VER	f
souhaités	VER	m
souhaiterai	VER	na
souhaitèrent	VER	na
souhaitât	VER	na
souhaiteront	VER	na
souhaites	VER	na
souhaiterions	VER	na
souhaitant	VER	na
souhaite	VER	na
souhaitait	VER	na
souhaitais	VER	na
souhaitaient	VER	na
souhaitent	VER	na
souhaiter	VER	na
souhaitera	VER	na
souhaiteraient	VER	na
souhaitez	VER	na
souhaitiez	VER	na
souhaiteriez	VER	na
souhaiterez	VER	na
souhaiteras	VER	na
souhaiterait	VER	na
souhaitions	VER	na
souhaitons	VER	na
souhaiterais	VER	na
souhaitâmes	VER	na
souhaitai	VER	na
souhaita	VER	na
souhaiterons	VER	na
bas	ADJ	m
basses	ADJ	f
basse	ADJ	f
missions	NOM	f
mission	NOM	f
créons	VER	na
créent	VER	na
créés	VER	na
créées	VER	f
créée	VER	f
créé	VER	m
créèrent	VER	na
créât	VER	na
créa	VER	na
créai	VER	na
créaient	VER	na
créais	VER	na
créait	VER	na
créant	VER	na
crée	VER	na
créer	VER	na
créiez	VER	na
créera	VER	na
créerai	VER	na
créeraient	VER	na
créerais	VER	na
créerait	VER	na
créerez	VER	na
créerons	VER	na
créeront	VER	na
créez	VER	na
créions	VER	na
pote	NOM	m
potes	NOM	m
chansons	NOM	f
chanson	NOM	f
surveilleras	VER	na
surveillions	VER	na
surveillons	VER	na
surveilliez	VER	na
surveillez	VER	na
surveilles	VER	na
surveilleront	VER	na
surveillerons	VER	na
surveillerez	VER	na
surveillerait	VER	na
surveillerais	VER	na
surveilleraient	VER	na
surveillerai	VER	na
surveillera	VER	na
surveiller	VER	na
surveillent	VER	na
surveille	VER	na
surveillant	VER	na
surveillait	VER	na
surveillais	VER	na
surveilla	VER	na
surveillaient	VER	na
surveillât	VER	na
surveillé	VER	m
surveillée	VER	f
surveillées	VER	f
surveillés	VER	m
simplement	ADV	na
recommençâmes	VER	na
recommencée	VER	f
recommences	VER	na
recommençons	VER	na
recommenceras	VER	na
recommencerez	VER	na
recommenceront	VER	na
recommencez	VER	na
recommenciez	VER	na
recommencions	VER	na
recommençât	VER	na
recommençait	VER	na
recommençant	VER	na
recommenceriez	VER	na
recommencerons	VER	na
recommencerions	VER	na
recommencées	VER	f
recommencés	VER	m
recommença	VER	na
recommençai	VER	na
recommençaient	VER	na
recommençais	VER	na
recommencèrent	VER	na
recommencerait	VER	na
recommence	VER	na
recommenceraient	VER	na
recommencerai	VER	na
recommencé	VER	m
recommencerais	VER	na
recommencera	VER	na
recommencer	VER	na
recommencent	VER	na
robe	NOM	f
robes	NOM	f
chauds	ADJ	m
chaudes	ADJ	f
chaude	ADJ	f
chaud	ADJ	m
billet	NOM	m
billets	NOM	m
spéciaux	ADJ	m
spéciales	ADJ	f
spéciale	ADJ	f
spécial	ADJ	m
moyens	NOM	m
moyen	NOM	m
sympas	ADJ	na
vaisseau	NOM	m
vaisseaux	NOM	m
sympa	ADJ	na
moi-même	PRO:per	na
coûtera	VER	na
coûtes	VER	na
coûter	VER	na
coûtés	VER	m
coûtées	VER	f
coûtée	VER	f
coûté	VER	m
coûtât	VER	na
coûtions	VER	na
coûtez	VER	na
coûterait	VER	na
coûteront	VER	na
coûtais	VER	na
coûtent	VER	na
coûteras	VER	na
coûtant	VER	na
coûtait	VER	na
coûte	VER	na
coûteraient	VER	na
coûterai	VER	na
coûtaient	VER	na
coûta	VER	na
surprise	NOM	f
surprises	NOM	f
postes	NOM	na
poste	NOM	na
comprise	ADJ	f
comprises	ADJ	f
compris	ADJ	m
anniversaires	NOM	m
anniversaire	NOM	m
signes	NOM	m
signe	NOM	m
vols	NOM	m
vol	NOM	m
couleurs	NOM	f
couleur	NOM	f
image	NOM	f
images	NOM	f
parient	VER	na
parions	VER	na
parierai	VER	na
parierais	VER	na
parierait	VER	na
parieriez	VER	na
paries	VER	na
pariez	VER	na
paria	VER	na
parié	VER	m
pariaient	VER	na
parie	VER	na
pariais	VER	na
pariant	VER	na
pariait	VER	na
parier	VER	na
est	NOM	m
arbre	NOM	m
arbres	NOM	m
bières	NOM	f
bière	NOM	f
mme	NOM	f
poisson	NOM	m
poissons	NOM	m
selon	PRE	na
a	NOM	m
intérêt	NOM	m
intérêts	NOM	m
lieutenant	NOM	m
lieutenants	NOM	m
danger	NOM	m
dangers	NOM	m
appartiendront	VER	na
appartins	VER	na
appartiendrait	VER	na
appartiendras	VER	na
appartiendrons	VER	na
appartenait	VER	na
appartenant	VER	na
appartint	VER	na
appartiendra	VER	na
appartinssent	VER	na
appartient	VER	na
appartînt	VER	na
appartiens	VER	na
appartiennent	VER	na
appartienne	VER	na
appartiendraient	VER	na
appartiendrai	VER	na
appartenez	VER	na
apparteniez	VER	na
appartenions	VER	na
appartenir	VER	na
appartenons	VER	na
appartenu	VER	m
appartiendrais	VER	na
appartenues	VER	f
appartenaient	VER	na
appartenais	VER	na
remarqué	VER	m
remarque	VER	na
remarquais	VER	na
remarqua	VER	na
remarquions	VER	na
remarquons	VER	na
remarquâmes	VER	na
remarquait	VER	na
remarquant	VER	na
remarquez	VER	na
remarquât	VER	na
remarquas	VER	na
remarquèrent	VER	na
remarquée	VER	f
remarquées	VER	f
remarqués	VER	m
remarquaient	VER	na
remarquiez	VER	na
remarques	VER	na
remarqueraient	VER	na
remarqueriez	VER	na
remarquent	VER	na
remarquer	VER	na
remarquai	VER	na
remarquerez	VER	na
remarquera	VER	na
remarqueras	VER	na
remarquerait	VER	na
remarquerais	VER	na
remarquerai	VER	na
remarqueront	VER	na
animaux	NOM	m
animal	NOM	m
rate	VER	na
ratant	VER	na
ratai	VER	na
rates	VER	na
ratais	VER	na
ratés	VER	m
rata	VER	na
rataient	VER	na
ratait	VER	na
rateront	VER	na
raterait	VER	na
rations	VER	na
raterez	VER	na
rateras	VER	na
ratèrent	VER	na
raterons	VER	na
ratée	VER	f
raterais	VER	na
raterai	VER	na
ratera	VER	na
ratons	VER	na
rateriez	VER	na
rater	VER	na
ratées	VER	f
raté	VER	m
ratent	VER	na
ratez	VER	na
ratiez	VER	na
retireront	VER	na
retirait	VER	na
retire	VER	na
retirerez	VER	na
retireriez	VER	na
retirerons	VER	na
retiraient	VER	na
retirerions	VER	na
retireraient	VER	na
retirais	VER	na
retirai	VER	na
retirerai	VER	na
retirerais	VER	na
retirerait	VER	na
retires	VER	na
retirés	VER	m
retiré	VER	m
retirèrent	VER	na
retirât	VER	na
retirâmes	VER	na
retirée	VER	f
retirées	VER	f
retirons	VER	na
retirions	VER	na
retiriez	VER	na
retira	VER	na
retirant	VER	na
retirer	VER	na
retirent	VER	na
retirera	VER	na
retireras	VER	na
retirez	VER	na
bord	NOM	m
bords	NOM	m
noires	NOM	f
noire	NOM	f
tentera	VER	na
tenterez	VER	na
tenterais	VER	na
tentèrent	VER	na
tentât	VER	na
tentâmes	VER	na
tentons	VER	na
tentions	VER	na
tentiez	VER	na
tentées	VER	f
tentez	VER	na
tentes	VER	na
tenteront	VER	na
tenterons	VER	na
tenteriez	VER	na
tenteras	VER	na
tentée	VER	f
tenterait	VER	na
noir	NOM	m
tenteraient	VER	na
tentés	VER	m
tenta	VER	na
tentai	VER	na
tentaient	VER	na
tentais	VER	na
tentait	VER	na
tentant	VER	na
tenté	VER	m
tente	VER	na
tentent	VER	na
tenter	VER	na
noirs	NOM	m
tenterai	VER	na
liberté	NOM	f
près	ADV	na
libertés	NOM	f
règle	NOM	f
règles	NOM	f
banque	NOM	f
banques	NOM	f
dînerai	VER	na
dîneraient	VER	na
dîneriez	VER	na
dînai	VER	na
dînais	VER	na
dînait	VER	na
dîna	VER	na
dînant	VER	na
dîne	VER	na
dînent	VER	na
dîné	VER	m
dîner	VER	na
dînera	VER	na
dînerais	VER	na
dînerait	VER	na
dîneras	VER	na
dînerez	VER	na
dînaient	VER	na
dînerions	VER	na
dîniez	VER	na
dînèrent	VER	na
dînât	VER	na
dînâmes	VER	na
dînons	VER	na
dînions	VER	na
dînez	VER	na
dîneront	VER	na
dînerons	VER	na
dînes	VER	na
merveilleuse	ADJ	f
merveilleux	ADJ	m
merveilleuses	ADJ	f
fière	ADJ	f
fier	ADJ	m
fières	ADJ	f
fiers	ADJ	m
partageras	VER	na
partagerions	VER	na
partagerons	VER	na
partagez	VER	na
partageront	VER	na
partages	VER	na
partagerez	VER	na
partageriez	VER	na
partagés	VER	m
partageâmes	VER	na
partageât	VER	na
partagiez	VER	na
partagions	VER	na
partagèrent	VER	na
partagé	VER	m
partagée	VER	f
partagées	VER	f
partagerais	VER	na
partagerait	VER	na
partagera	VER	na
partageraient	VER	na
partageait	VER	na
partagerai	VER	na
partagea	VER	na
partageai	VER	na
partageaient	VER	na
partageais	VER	na
partage	VER	na
partagent	VER	na
partageons	VER	na
partager	VER	na
partageant	VER	na
classes	NOM	f
classe	NOM	f
dossiers	NOM	m
dossier	NOM	m
ressentiras	VER	na
ressentir	VER	na
ressentira	VER	na
ressentirai	VER	na
ressentirais	VER	na
ressentirait	VER	na
ressentiront	VER	na
ressentirez	VER	na
ressentiriez	VER	na
ressentirions	VER	na
ressentis	VER	m
ressentiez	VER	na
ressentions	VER	na
ressentent	VER	na
ressens	VER	na
ressent	VER	na
ressentaient	VER	na
ressentais	VER	na
ressentait	VER	na
ressentant	VER	na
ressente	VER	na
ressentons	VER	na
ressentes	VER	na
ressentez	VER	na
ressenti	VER	m
ressenties	VER	f
ressentit	VER	na
ressentirent	VER	na
ressentie	VER	f
ressentîmes	VER	na
ressentît	VER	na
bonheurs	NOM	m
bonheur	NOM	m
d'autres	PRO:ind	na
défendrez	VER	na
défendais	VER	na
défendait	VER	na
défendant	VER	na
défende	VER	na
défendent	VER	na
défendes	VER	na
défendez	VER	na
défendiez	VER	na
défendre	VER	na
défendrons	VER	na
défendriez	VER	na
défendras	VER	na
défendront	VER	na
défends	VER	na
défendu	VER	m
défendue	VER	f
défendions	VER	na
défendirent	VER	na
défendues	VER	f
défendus	VER	m
défendît	VER	na
défend	VER	na
défendaient	VER	na
défendit	VER	na
défendons	VER	na
défendra	VER	na
défendrait	VER	na
défendrais	VER	na
défendraient	VER	na
défendrai	VER	na
défendis	VER	na
chéri	ADJ	m
chéris	ADJ	m
chéries	ADJ	f
chérie	ADJ	f
buts	NOM	m
but	NOM	m
bandes	NOM	f
bande	NOM	f
l	ART:def	na
fatiguerait	VER	na
fatiguaient	VER	na
fatiguai	VER	na
fatiguât	VER	na
fatiguais	VER	na
fatigues	VER	na
fatiguons	VER	na
fatiguait	VER	na
fatigua	VER	na
fatiguerai	VER	na
fatiguez	VER	na
fatiguèrent	VER	na
fatiguerais	VER	na
fatiguant	VER	na
fatigue	VER	na
fatiguent	VER	na
fatiguer	VER	na
fatigueraient	VER	na
fatigueras	VER	na
fatiguera	VER	na
fatiguée	VER	f
fatigué	VER	m
fatiguées	VER	f
fatigués	VER	m
radio	NOM	na
radios	NOM	na
prévue	VER	f
prévois	VER	na
prévit	VER	na
prévoie	VER	na
prévoient	VER	na
prévoies	VER	na
prévoir	VER	na
prévoira	VER	na
prévoirait	VER	na
prévoit	VER	na
prévu	VER	m
prévoyaient	VER	na
prévus	VER	m
prévoyait	VER	na
prévues	VER	f
prévoyez	VER	na
prévoyions	VER	na
prévoyons	VER	na
prévoyais	VER	na
prévoyant	VER	na
celui-là	PRO:dem	m
hauts	NOM	m
haut	NOM	m
camarade	NOM	na
camarades	NOM	na
doutais	VER	na
doutiez	VER	na
douterez	VER	na
douteriez	VER	na
douteront	VER	na
doutes	VER	na
doutez	VER	na
doutèrent	VER	na
doutai	VER	na
douterait	VER	na
douté	VER	m
douta	VER	na
doutée	VER	f
doutés	VER	m
douteras	VER	na
douterai	VER	na
douterais	VER	na
doutera	VER	na
doutions	VER	na
douter	VER	na
doutons	VER	na
doutent	VER	na
doute	VER	na
doutant	VER	na
doutât	VER	na
doutait	VER	na
doutaient	VER	na
droit	ADJ	m
droite	ADJ	f
droites	ADJ	f
droits	ADJ	m
oiseau	NOM	m
oiseaux	NOM	m
vent	NOM	m
vents	NOM	m
recherches	NOM	f
recherche	NOM	f
derniers	NOM	m
dernier	NOM	m
dernière	NOM	f
dernières	NOM	f
appréciera	VER	na
apprécierons	VER	na
appréciait	VER	na
appréciant	VER	na
apprécie	VER	na
apprécient	VER	na
apprécier	VER	na
appréciai	VER	na
apprécierai	VER	na
apprécies	VER	na
apprécieraient	VER	na
apprécierais	VER	na
apprécierions	VER	na
apprécieriez	VER	na
apprécierait	VER	na
apprécieront	VER	na
appréciions	VER	na
appréciez	VER	na
apprécia	VER	na
appréciaient	VER	na
apprécieras	VER	na
appréciais	VER	na
appréciés	VER	m
appréciées	VER	f
appréciée	VER	f
apprécié	VER	m
apprécièrent	VER	na
appréciât	VER	na
apprécions	VER	na
apprécierez	VER	na
systèmes	NOM	m
système	NOM	m
fermes	NOM	f
ferme	NOM	f
capables	ADJ	na
capable	ADJ	na
fuirions	VER	na
fuirons	VER	na
fuient	VER	na
fuie	VER	f
fuisse	VER	na
fuis	VER	m
fuiront	VER	na
fuiriez	VER	na
fuirez	VER	na
fuies	VER	na
fuirent	VER	na
fuir	VER	na
fuira	VER	na
fuirai	VER	na
fuiraient	VER	na
fuirais	VER	na
fuirait	VER	na
fuit	VER	na
fuiras	VER	na
fuyons	VER	na
fuyions	VER	na
fuyiez	VER	na
fui	VER	m
fuyez	VER	na
fuyant	VER	na
fuyait	VER	na
fuyais	VER	na
fuyaient	VER	na
ennui	NOM	m
ennuis	NOM	m
tante	NOM	f
tantes	NOM	f
héros	NOM	m
héroïne	NOM	f
héroïnes	NOM	f
dedans	ADV	na
excellentes	ADJ	f
excellent	ADJ	m
excellente	ADJ	f
excellents	ADJ	m
pitiés	NOM	f
pitié	NOM	f
appartements	NOM	m
appartement	NOM	m
bossant	VER	na
bossa	VER	na
bossé	VER	m
bossaient	VER	na
bossons	VER	na
bosseras	VER	na
bossais	VER	na
bossait	VER	na
bosserait	VER	na
bosse	VER	na
bossez	VER	na
bosserais	VER	na
bosserez	VER	na
bosses	VER	na
bossent	VER	na
bosserai	VER	na
bossiez	VER	na
bossions	VER	na
bosser	VER	na
bossera	VER	na
respirez	VER	na
respirerez	VER	na
respiriez	VER	na
respirât	VER	na
respirèrent	VER	na
respiré	VER	m
respirée	VER	f
respires	VER	na
respirées	VER	f
respirés	VER	m
respirerons	VER	na
respireront	VER	na
respirant	VER	na
respirons	VER	na
respireras	VER	na
respirerai	VER	na
respirerait	VER	na
respirai	VER	na
respiraient	VER	na
respirais	VER	na
respirait	VER	na
respirions	VER	na
respire	VER	na
respirent	VER	na
respirera	VER	na
respirer	VER	na
respira	VER	na
respirerais	VER	na
entières	ADJ	f
entier	ADJ	m
entiers	ADJ	m
entière	ADJ	f
récupérâmes	VER	na
récupérées	VER	f
récupérèrent	VER	na
récupérés	VER	m
récupérée	VER	f
récupéré	VER	m
récupéreront	VER	na
récupérons	VER	na
récupérions	VER	na
récupériez	VER	na
récupérez	VER	na
récupérerai	VER	na
récupérerons	VER	na
récupérerez	VER	na
récupère	VER	na
récupèrent	VER	na
récupères	VER	na
récupéra	VER	na
récupérai	VER	na
récupéraient	VER	na
récupérais	VER	na
récupérant	VER	na
récupérer	VER	na
récupérera	VER	na
récupérerais	VER	na
récupérerait	VER	na
récupéreras	VER	na
récupérait	VER	na
douleurs	NOM	f
douleur	NOM	f
libérer	VER	na
libérera	VER	na
libérons	VER	na
libérerons	VER	na
libéra	VER	na
libères	VER	na
libèrent	VER	na
libère	VER	na
libérerais	VER	na
libérerait	VER	na
libéreras	VER	na
libérerez	VER	na
libéreront	VER	na
libéraient	VER	na
libérez	VER	na
libériez	VER	na
libérions	VER	na
libérât	VER	na
libérèrent	VER	na
libéré	VER	m
libérée	VER	f
libérées	VER	f
libérai	VER	na
libérés	VER	m
libérais	VER	na
libérant	VER	na
libérait	VER	na
libérerai	VER	na
libéreraient	VER	na
sentiment	NOM	m
sentiments	NOM	m
grand-père	NOM	m
grands-pères	NOM	m
société	NOM	f
sociétés	NOM	f
lanceront	VER	na
lances	VER	na
lancé	VER	m
lancerons	VER	na
lancent	VER	na
lançais	VER	na
lançaient	VER	na
lançai	VER	na
lança	VER	na
lancée	VER	f
lancées	VER	f
lancés	VER	m
lancions	VER	na
lanceras	VER	na
lanciez	VER	na
lancez	VER	na
lance	VER	na
lancerais	VER	na
lancerez	VER	na
lancer	VER	na
lancera	VER	na
lanceraient	VER	na
lancerai	VER	na
lancerait	VER	na
lancèrent	VER	na
lançât	VER	na
lançâmes	VER	na
lançons	VER	na
lançait	VER	na
lanças	VER	na
lançant	VER	na
nez	NOM	m
joies	NOM	f
joie	NOM	f
relation	NOM	f
relations	NOM	f
témoin	NOM	m
témoins	NOM	m
actrices	NOM	f
moitié	NOM	f
moitiés	NOM	f
actrice	NOM	f
acteur	NOM	m
acteurs	NOM	m
incroyables	ADJ	na
incroyable	ADJ	na
bain	NOM	m
bains	NOM	m
dure	VER	na
durèrent	VER	na
durassent	VER	na
dureras	VER	na
durées	VER	f
durerez	VER	na
durant	VER	na
durée	VER	f
dures	VER	na
duré	VER	m
durât	VER	na
dura	VER	na
durera	VER	na
dureront	VER	na
durer	VER	na
durait	VER	na
durent	VER	na
durerai	VER	na
durerait	VER	na
duraient	VER	na
dureraient	VER	na
durerais	VER	na
marché	NOM	m
marchés	NOM	m
lavées	VER	f
laverions	VER	na
lavera	VER	na
laverai	VER	na
laverais	VER	na
laverait	VER	na
laveras	VER	na
laverez	VER	na
laverons	VER	na
lave	VER	na
laveront	VER	na
laves	VER	na
lavez	VER	na
lavions	VER	na
lavons	VER	na
lavèrent	VER	na
lavent	VER	na
laver	VER	na
lavé	VER	m
lavai	VER	na
lavasse	VER	na
lavant	VER	na
lavait	VER	na
lavaient	VER	na
lavais	VER	na
lava	VER	na
lavée	VER	f
lavés	VER	m
dent	NOM	f
dents	NOM	f
idiots	ADJ	m
idiote	ADJ	f
idiotes	ADJ	f
idiot	ADJ	m
là-dedans	ADV	na
mademoiselle	NOM	f
mademoiselles	NOM	f
adresses	NOM	f
adresse	NOM	f
cousin	NOM	m
cousines	NOM	f
cousine	NOM	f
cousins	NOM	m
riche	ADJ	na
riches	ADJ	na
compagnie	NOM	f
compagnies	NOM	f
sonnaient	VER	na
sonnai	VER	na
sonna	VER	na
sonnés	VER	m
sonnais	VER	na
sonnerai	VER	na
sonnées	VER	f
sonnée	VER	f
sonné	VER	m
sonnèrent	VER	na
sonnât	VER	na
sonnait	VER	na
sonniez	VER	na
sonnez	VER	na
sonnes	VER	na
sonneront	VER	na
sonnerez	VER	na
sonneras	VER	na
sonnerait	VER	na
sonnerais	VER	na
sonnons	VER	na
sonnent	VER	na
sonnant	VER	na
sonnera	VER	na
sonner	VER	na
sonne	VER	na
chaussures	NOM	f
chaussure	NOM	f
oreille	NOM	f
oreilles	NOM	f
derrière	ADV	na
supers	NOM	m
super	NOM	m
grand-mère	NOM	f
grand-mères	NOM	f
grands-mères	NOM	f
anciennes	ADJ	f
anciens	ADJ	m
ancienne	ADJ	f
ancien	ADJ	m
arts	NOM	m
art	NOM	m
devinât	VER	na
devinerai	VER	na
deviner	VER	na
devineras	VER	na
devine	VER	na
devinâmes	VER	na
devinant	VER	na
devinera	VER	na
devinées	VER	f
devinés	VER	m
devinée	VER	f
devinais	VER	na
devinent	VER	na
deviné	VER	m
devinerez	VER	na
devinons	VER	na
devineraient	VER	na
devinions	VER	na
devinez	VER	na
devines	VER	na
devineront	VER	na
devineriez	VER	na
devinèrent	VER	na
devinait	VER	na
devinerait	VER	na
devinai	VER	na
devina	VER	na
devinaient	VER	na
devinerais	VER	na
inutiles	ADJ	na
inutile	ADJ	na
ravirait	VER	na
ravir	VER	na
ravissant	VER	na
ravissait	VER	na
ravissaient	VER	na
ravis	VER	m
raviront	VER	na
ravirent	VER	na
ravit	VER	na
ravi	VER	m
ravies	VER	f
ravie	VER	f
ravissent	VER	na
ravisse	VER	na
blague	NOM	f
blagues	NOM	f
avenir	NOM	m
avenirs	NOM	m
beauté	NOM	f
beautés	NOM	f
laisse	NOM	f
laisses	NOM	f
course	NOM	f
courses	NOM	f
manière	NOM	f
manières	NOM	f
traversées	VER	f
traversés	VER	m
traversons	VER	na
traversée	VER	f
traverseraient	VER	na
traversa	VER	na
traversai	VER	na
traversaient	VER	na
traversais	VER	na
traversait	VER	na
traversant	VER	na
traverse	VER	na
traverser	VER	na
traversera	VER	na
traverserai	VER	na
traverserais	VER	na
traversé	VER	m
traverseras	VER	na
traverserez	VER	na
traverserons	VER	na
traverseront	VER	na
traverses	VER	na
traversez	VER	na
traversiez	VER	na
traversions	VER	na
traversâmes	VER	na
traversèrent	VER	na
traverserait	VER	na
traversent	VER	na
expériences	NOM	f
expérience	NOM	f
soin	NOM	m
soins	NOM	m
hors	PRE	na
cour	NOM	f
gauche	NOM	na
bas	NOM	m
gauches	NOM	na
stupide	ADJ	na
stupides	ADJ	na
aucun	PRO:ind	m
retienne	VER	na
retînt	VER	na
reteniez	VER	na
retînmes	VER	na
retenez	VER	na
retenant	VER	na
retenait	VER	na
retenaient	VER	na
retenais	VER	na
retiens	VER	na
retinrent	VER	na
retient	VER	na
retint	VER	na
retenions	VER	na
retiennes	VER	na
retiendront	VER	na
retiendraient	VER	na
retiendrons	VER	na
retiendrions	VER	na
retiendrez	VER	na
retiendras	VER	na
retiendrait	VER	na
retiendrais	VER	na
retiendrai	VER	na
retenir	VER	na
retiendra	VER	na
retenus	VER	m
retenues	VER	f
retiennent	VER	na
retenu	VER	m
retenons	VER	na
retenue	VER	f
retins	VER	na
listes	NOM	f
liste	NOM	f
remonte	VER	na
remonta	VER	na
remontaient	VER	na
remontais	VER	na
remontait	VER	na
remontés	VER	m
remontées	VER	f
remontée	VER	f
remonté	VER	m
remontèrent	VER	na
remontât	VER	na
remontâmes	VER	na
remontons	VER	na
remontant	VER	na
remontent	VER	na
remonter	VER	na
remontera	VER	na
remonterai	VER	na
remonteraient	VER	na
remonterait	VER	na
remonteras	VER	na
remonterez	VER	na
remonteriez	VER	na
remontions	VER	na
remonterons	VER	na
remonteront	VER	na
remontes	VER	na
remontai	VER	na
remontez	VER	na
remontiez	VER	na
réalisât	VER	na
réalisée	VER	f
réaliserait	VER	na
réaliseras	VER	na
réaliserez	VER	na
réaliserions	VER	na
réalisés	VER	m
réalisées	VER	f
réalisé	VER	m
réaliseraient	VER	na
réalisèrent	VER	na
réaliseront	VER	na
réalisâmes	VER	na
réalisons	VER	na
réalisions	VER	na
réalisiez	VER	na
réaliserais	VER	na
réaliserai	VER	na
réalises	VER	na
réalisait	VER	na
réalisa	VER	na
réalisai	VER	na
réalisaient	VER	na
réalisais	VER	na
réalisera	VER	na
réalisez	VER	na
réalisant	VER	na
réalise	VER	na
réalisent	VER	na
réaliser	VER	na
i	NOM	na
moquerez	VER	na
moqueras	VER	na
moquerait	VER	na
moqueriez	VER	na
moqua	VER	na
moquai	VER	na
moquent	VER	na
moquaient	VER	na
moquais	VER	na
moquait	VER	na
moquant	VER	na
moque	VER	na
moqués	VER	m
moquées	VER	f
moquée	VER	f
moqué	VER	m
moquer	VER	na
moqueront	VER	na
moquerais	VER	na
moquèrent	VER	na
moquerai	VER	na
moquât	VER	na
moquons	VER	na
moquions	VER	na
moquiez	VER	na
moquez	VER	na
moques	VER	na
moqueraient	VER	na
moquera	VER	na
étudiera	VER	na
étudierai	VER	na
étudiées	VER	f
étudiés	VER	m
étudia	VER	na
étudiai	VER	na
étudiaient	VER	na
étudier	VER	na
étudierais	VER	na
étudié	VER	m
étudiais	VER	na
étudiait	VER	na
étudiant	VER	na
étudierait	VER	na
étudieras	VER	na
étudie	VER	na
étudiée	VER	f
étudient	VER	na
étudiez	VER	na
étudierez	VER	na
étudierions	VER	na
étudièrent	VER	na
étudions	VER	na
étudierons	VER	na
étudies	VER	na
installerai	VER	na
installions	VER	na
installons	VER	na
installâmes	VER	na
installaient	VER	na
installât	VER	na
installez	VER	na
installèrent	VER	na
installé	VER	m
installée	VER	f
installées	VER	f
installés	VER	m
installa	VER	na
installiez	VER	na
installerons	VER	na
installes	VER	na
installeront	VER	na
installera	VER	na
installerions	VER	na
installerez	VER	na
installeras	VER	na
installais	VER	na
installait	VER	na
installant	VER	na
installasse	VER	na
installe	VER	na
installent	VER	na
installer	VER	na
installerais	VER	na
installeraient	VER	na
installerait	VER	na
installai	VER	na
courage	NOM	m
courages	NOM	m
bleue	ADJ	f
bleus	ADJ	m
bleues	ADJ	f
bleu	ADJ	na
secours	NOM	m
milieux	NOM	m
milieu	NOM	m
proposés	VER	m
proposerons	VER	na
proposerions	VER	na
proposerai	VER	na
proposée	VER	f
proposeriez	VER	na
proposeras	VER	na
proposerait	VER	na
proposerais	VER	na
proposeraient	VER	na
proposerez	VER	na
proposera	VER	na
proposer	VER	na
proposèrent	VER	na
proposent	VER	na
proposez	VER	na
proposiez	VER	na
propose	VER	na
proposant	VER	na
proposait	VER	na
proposais	VER	na
proposaient	VER	na
proposai	VER	na
proposa	VER	na
proposions	VER	na
proposé	VER	m
proposées	VER	f
proposât	VER	na
proposons	VER	na
proposes	VER	na
proposeront	VER	na
proposâmes	VER	na
m	NOM	m
contacts	NOM	m
contact	NOM	m
inspecteur	NOM	m
inspectrice	NOM	f
inspecteurs	NOM	m
mignonne	ADJ	f
mignonnes	ADJ	f
mignon	ADJ	m
mignons	ADJ	m
projet	NOM	m
projets	NOM	m
probablement	ADV	na
rôle	NOM	m
rôles	NOM	m
risque	NOM	m
risques	NOM	m
actions	NOM	f
anges	NOM	m
action	NOM	f
ange	NOM	m
avances	NOM	f
avance	NOM	f
intéressantes	ADJ	f
intéressante	ADJ	f
intéressants	ADJ	m
intéressant	ADJ	m
parmi	PRE	na
langues	NOM	f
langue	NOM	f
emportiez	VER	na
emportait	VER	na
emportez	VER	na
emporté	VER	m
emporterai	VER	na
emporteraient	VER	na
emportant	VER	na
emportée	VER	f
emportent	VER	na
emportai	VER	na
emportes	VER	na
emporter	VER	na
emporte	VER	na
emportais	VER	na
emportées	VER	f
emportaient	VER	na
emportions	VER	na
emportera	VER	na
emportons	VER	na
emportés	VER	m
emporteras	VER	na
emporterez	VER	na
emporterait	VER	na
emporteriez	VER	na
emporterions	VER	na
emporterons	VER	na
emportèrent	VER	na
emportât	VER	na
emporteront	VER	na
emporterais	VER	na
emporta	VER	na
thé	NOM	m
thés	NOM	m
laquelle	PRO:int	na
laquelle	PRO:rel	f
colère	NOM	f
colères	NOM	f
pauvre	NOM	na
pauvres	NOM	na
départ	NOM	m
départs	NOM	m
époques	NOM	f
époque	NOM	f
engagerai	VER	na
engageant	VER	na
engageâmes	VER	na
engagez	VER	na
engageaient	VER	na
engagées	VER	f
engagée	VER	f
engagent	VER	na
engagiez	VER	na
engagé	VER	m
engagions	VER	na
engagerait	VER	na
engagèrent	VER	na
engagerons	VER	na
engageai	VER	na
engagés	VER	m
engages	VER	na
engageait	VER	na
engagea	VER	na
engageons	VER	na
engagera	VER	na
engageraient	VER	na
engagerions	VER	na
engageais	VER	na
engagerais	VER	na
engageât	VER	na
engager	VER	na
engageriez	VER	na
engage	VER	na
engageront	VER	na
voleuse	NOM	f
voleurs	NOM	m
voleuses	NOM	f
voleur	NOM	m
cessasse	VER	na
cesserais	VER	na
cesseras	VER	na
cesserez	VER	na
cesseriez	VER	na
cesserons	VER	na
cesses	VER	na
cessez	VER	na
cessiez	VER	na
cessions	VER	na
cessons	VER	na
cessâmes	VER	na
cessât	VER	na
cessèrent	VER	na
cessé	VER	m
cessée	VER	f
cessa	VER	na
cesserait	VER	na
cesseront	VER	na
cesseraient	VER	na
cessent	VER	na
cessant	VER	na
cessait	VER	na
cessais	VER	na
cessaient	VER	na
cesserai	VER	na
cessai	VER	na
cesse	VER	na
cessera	VER	na
cesser	VER	na
haut	ADJ	m
hauts	ADJ	m
haute	ADJ	f
hautes	ADJ	f
tort	NOM	m
torts	NOM	m
vacance	NOM	f
vacances	NOM	f
là-haut	ADV	na
signifiera	VER	na
signifiait	VER	na
signifiant	VER	na
signifie	VER	na
signifient	VER	na
signifier	VER	na
machines	NOM	f
signifierait	VER	na
signifiât	VER	na
signifièrent	VER	na
signifié	VER	m
signifiée	VER	f
signifiées	VER	f
machine	NOM	f
signifiaient	VER	na
signifiais	VER	na
signifierai	VER	na
signifia	VER	na
répareras	VER	na
réparés	VER	m
réparèrent	VER	na
répareront	VER	na
réparons	VER	na
réparent	VER	na
répareraient	VER	na
réparaient	VER	na
réparais	VER	na
réparait	VER	na
réparerons	VER	na
réparée	VER	f
répare	VER	na
réparant	VER	na
réparerai	VER	na
réparera	VER	na
répara	VER	na
répariez	VER	na
réparer	VER	na
réparerez	VER	na
réparées	VER	f
réparé	VER	m
réparions	VER	na
réparerait	VER	na
réparez	VER	na
bêtes	NOM	f
bête	NOM	f
construisit	VER	na
construisons	VER	na
construisirent	VER	na
construisions	VER	na
construisît	VER	na
construit	VER	m
construira	VER	na
construirais	VER	na
construites	VER	f
construits	VER	m
construirai	VER	na
construite	VER	f
construire	VER	na
construirons	VER	na
construisant	VER	na
construiriez	VER	na
construisez	VER	na
construirez	VER	na
construisait	VER	na
construisais	VER	na
construise	VER	na
construisaient	VER	na
construis	VER	na
construiras	VER	na
construiront	VER	na
construisiez	VER	na
construisent	VER	na
construiraient	VER	na
construisis	VER	na
construirait	VER	na
pain	NOM	m
pains	NOM	m
bar	NOM	m
bars	NOM	m
chier	VER	na
chiez	VER	na
chiera	VER	na
chieront	VER	na
chies	VER	na
chierez	VER	na
chiée	VER	f
chia	VER	na
chiaient	VER	na
chie	VER	na
chiant	VER	na
chierai	VER	na
chierais	VER	na
chiais	VER	na
chient	VER	na
chié	VER	m
chieras	VER	na
chiait	VER	na
chiées	VER	f
chiés	VER	m
clubs	NOM	m
club	NOM	m
étés	NOM	m
été	NOM	m
horrible	ADJ	na
horribles	ADJ	na
profiteriez	VER	na
profitait	VER	na
profita	VER	na
profitai	VER	na
profiterons	VER	na
profiterez	VER	na
profiteras	VER	na
profiteront	VER	na
profiterait	VER	na
profites	VER	na
profitez	VER	na
profitiez	VER	na
profiterais	VER	na
profitions	VER	na
profitons	VER	na
profitâmes	VER	na
profitât	VER	na
profiteraient	VER	na
profiterai	VER	na
profitera	VER	na
profitèrent	VER	na
profité	VER	m
profiter	VER	na
profitée	VER	f
profitent	VER	na
profite	VER	na
profitant	VER	na
profitais	VER	na
profitaient	VER	na
pierre	NOM	f
pleuvait	VER	na
plu	VER	m
pleuvrait	VER	na
pleut	VER	na
pleuvaient	VER	na
pleuvant	VER	na
pleuvra	VER	na
pleuvoir	VER	na
pleuvent	VER	na
pleuve	VER	na
pierres	NOM	f
plusieurs	ADJ:ind	na
salopes	NOM	f
salope	NOM	f
bon	ADV	na
tel	ADJ:ind	m
glace	NOM	f
glaces	NOM	f
présent	NOM	m
présents	NOM	m
calmes	ADJ	na
calme	ADJ	na
décision	NOM	f
décisions	NOM	f
juge	NOM	m
juges	NOM	m
contrôle	NOM	m
contrôles	NOM	m
séparé	VER	m
séparions	VER	na
séparais	VER	na
séparez	VER	na
séparaient	VER	na
sépariez	VER	na
séparât	VER	na
séparons	VER	na
séparâmes	VER	na
séparés	VER	m
séparai	VER	na
séparée	VER	f
sépareront	VER	na
séparèrent	VER	na
séparerons	VER	na
séparerai	VER	na
sépare	VER	na
séparent	VER	na
séparer	VER	na
séparant	VER	na
séparerez	VER	na
séparait	VER	na
sépara	VER	na
séparera	VER	na
sépareraient	VER	na
séparerais	VER	na
séparerait	VER	na
sépareras	VER	na
séparées	VER	f
sept	ADJ:num	na
maladie	NOM	f
maladies	NOM	f
sure	ADJ	f
sur	ADJ	m
surs	ADJ	m
sures	ADJ	f
amies	ADJ	f
amie	ADJ	f
amis	ADJ	m
ami	ADJ	m
quartiers	NOM	m
quartier	NOM	m
désirerais	VER	na
désires	VER	na
désirez	VER	na
désiriez	VER	na
désirions	VER	na
désirât	VER	na
désirons	VER	na
désireront	VER	na
désiré	VER	m
désirée	VER	f
désirées	VER	f
désirés	VER	m
désira	VER	na
désireraient	VER	na
désiraient	VER	na
désireras	VER	na
désirais	VER	na
désirera	VER	na
désirerait	VER	na
désirerions	VER	na
désireriez	VER	na
désirer	VER	na
désirent	VER	na
désire	VER	na
désirant	VER	na
désirait	VER	na
travers	NOM	m
dommages	NOM	m
dommage	NOM	m
cigarettes	NOM	f
cigarette	NOM	f
traînai	VER	na
traîneront	VER	na
traîna	VER	na
traînaient	VER	na
traînais	VER	na
traînez	VER	na
traînerons	VER	na
traînait	VER	na
traînant	VER	na
traîne	VER	na
traîniez	VER	na
traînes	VER	na
traînèrent	VER	na
traînés	VER	m
traîneraient	VER	na
traînerez	VER	na
traîneras	VER	na
traînerait	VER	na
traînons	VER	na
traînions	VER	na
traînerais	VER	na
traînera	VER	na
traînées	VER	f
traîner	VER	na
traînâmes	VER	na
traînent	VER	na
traînât	VER	na
traîné	VER	m
traînée	VER	f
traînerai	VER	na
respectera	VER	na
respecterait	VER	na
respectais	VER	na
respectiez	VER	na
respectés	VER	m
respectent	VER	na
respections	VER	na
respectons	VER	na
respecta	VER	na
respectai	VER	na
respectées	VER	f
respecter	VER	na
respectaient	VER	na
respectez	VER	na
respectes	VER	na
respectant	VER	na
respecteront	VER	na
respecterai	VER	na
respecterons	VER	na
respectait	VER	na
respectée	VER	f
respecté	VER	m
respectât	VER	na
respecterais	VER	na
respecteraient	VER	na
respecterez	VER	na
respecteras	VER	na
respecte	VER	na
époux	NOM	m
épouse	NOM	f
épouses	NOM	f
tas	NOM	m
enfuyez	VER	na
enfuiras	VER	na
enfuirent	VER	na
enfuiront	VER	na
enfuyait	VER	na
enfuyais	VER	na
enfuyaient	VER	na
enfuie	VER	f
enfuirait	VER	na
enfuit	VER	na
enfuyant	VER	na
enfuirais	VER	na
enfuis	VER	m
enfuyons	VER	na
